-----------o--o-------?--?-----B-----------o------E--X--B----M----?----------------o-?----------------?--------B-----------B---------------B???-------------?o-----B--B-o--X-------------M--?---?E---EX-
--------E----E-?-----oBB--------------BE----------EB----B---M--------o-----------X-----------o----o-o---XX-o---------------?----------?-X----------X------o-------M--o----------?-----------------?-----
---------B??-M-----------------------------M--M--E-----o-------Mo-------E--B-----------------o-------B----?--------?---B---X-----T--B------------o-------------o--------M-----------B-----------E-------
------E?-------E--E-----M-?-----------------E--M-----------o----------E---E------?-------B------M?-----E---------------------?-?--------B---?----B---o--------?--E------ME--------E--------o------------
--oE--?----------B-?------------------E-----------------------------oB--------o---T-----------------------EM--------?---E--T----TXE---MB-------?--T------------------------B-----E---E------------------
-------M----E--------------------------B--------------E-o---o----o----X-----?---?------------M------------B?------?--M----------------X---o------------------------------------B------------M-?---------
-?--?--?-----------E?E----------------o------------?----M--E------------------------?---------o--B---X-?-------------B---E---------M-------------E-------??-X----BE-----?----M--------------------------
------?----B--?--X------------------o-B------?B--M--------T----X-------E------?o---------------------E---------------------------M------o---------E----------?----------------E--------E-------M----?--v
----------------B-------------------------------E-E-E-----B-------------o--------M---o---M----X----?-----------------------E------oE------B------?--B--E-?---------BM--E-oEM?----?B---E------E---------f
-----EX------E--o-----B-X-o------------?-E-?-------B-M-M----E-------B--?-------o--?-E--M-------M---------------------------------X----------------B-?E----?----------E-----o--E-------?E--------------?f
-BT---------?---o---M------?-B----------M---B----------------------X----------------E----------?----------?-----B---------?-----------------------E-------E----------?---E-----o-----M----E----------T-f
------o?----------------------E--o---?----B--------------ME----------------------X----M-E---------B-MM---E--o----------XB---------------M-------------------?---B-----------E-----?----------B---o----?f
-o----------------B------?---M-----o------------B--E--o-----------E----------------?E---?-E------?-----------?----------------------------------------?-oE-----B?---M?------M--E-----M----------B--M--Bf
------BEE-------------------MB?---------B-------o-B--------------oM----------?X-----------------------o--o-----E------------?--------o-E-X-------------o--X-oo------------------------B--M------E------f
m-?-----B-M-o---B--B-----?-----------------?-?-E--?--B-?-E-?-T-----------?-------E-----------T-?----E------?-E-------------E----B---E-B?---?----M--------?---------E---EB----T--------------E---?-?----X
XXXXXXXXXXXXXXXXXXXXXXXXXXXXXXXXXXXXXXXXXXXXXXXXXXXXXXXXXXXXXXXXXXXXXXXXXXXXXXXXXXXXXXXXXXXXXXXXXXXXXXXXXXXXXXXXXXXXXXXXXXXXXXXXXXXXXXXXXXXXXXXXXXXXXXXXXXXXXXXXXXXXXXXXXXXXXXXXXXXXXXXXXXXXXXXXXXXXXXXX
