------M---oo-----?-------------B?-----B-----------?-E-----------------------o----------------E----B--------?-----M--?-----------?-----o-M------B------o---------o-----?o----X-----o---o---E-----M----o--
--E-----?------ME------o------E-------B---M------o----------M-----------o----o-E-E--------------------E---B---------T-------?--------B----?--E------E?-E-E------E--o----M---E------X-?--E---------?-----
-o---------------------o--BE--?--B-?------?-----E-------------???-BEE-E--------------BE-----o-X-------------------E-E---M-M------?--E----------XB-----------------B--------------E-B----------------o-E-
----B?-------M------?-----oB----------------EX---E----------------------------o----??---o-----------oX----?----o------MB----?-----o--E------------------?----oo-?-?----------?---?---?---?-----------E--
---X----o------------B----??------T--B-------?--Eo--------EX-----------ME-E-o---------o----E----o--M-E---B--?------o----------oE---X-----------ME-?------M----M------?--------o---------------o---B-??--
-M-B---------?E-E-MBo-------E-------B-------o---E--?--EM-------BB----?--?----M----------o-?-----?-----??--------o--?--?---o?----------E----o?-----------B---------o--E-----M-M--B-----oE-----TE-MBo-----
------------------------?-----E---E--?-M------?-o---E---?----E----?--o-----------E---o------------------B-??---E---------M-----M-----T------o----------o--?---------o------?EM--B------------------B--o-
-------o?---------?---B----------------M----B-?-?--o-----?B----o------------B---------TB---oE---------------E----o--------------E--o--------B---?E-?-----E-o---o--E--------?--B----?-------?------Bo--Bv
---o------??---oo------------------X----------B--------E-M---M---?-?B-----M--?-----o?---------o----B?---------?-------E--?----?----?----MB-?---------EE-o-EM------?---------o---?---oB---?E------B---E-f
----B?-E----M-E--B--B-o-o---------------------B---------oEE--o--?---B--Mo-------?----o------------o----------E------o-----T--o--------M--------B-----B----T---------E----M---oo-------o-------------E-of
-X----------M-----------E--?B?--o---o----B--E--X----------?----E-----E--M-------------?---?M---------M-------------?------X--?-----------o------M-EE------M-XE------------oE---E--------------B?-------f
-------B------?-----------?Bo------------E------o-Eo----------BX-oo-B--E------------------------B-?---E----------B----M---------------B----------o-B--M----?E------B--------?------B---M-B----o--?-----f
-o-B-oMo--------------------------------o---M---------------?---B---E----o--o-----X--------o-------------EM--B-M----------?--E---M-E---------------?---M------o-E-------?----EE-----------B--------E---f
----o--B------E-----B--E?------E-------o------E--E-?----E----------B------------o-BE---------------------------E----?-----B-------?--------?---?------------------------M---------------?---oX---oE----f
m---?-----?-X-?--B------?-B--T-----EE--BE---B?-----B--oBE-?---E-?-o-o------B?---B---?-B--E--?----B---?---B---X--M-E-------?---??--?-B?-oX--X---------E-B-B-----?-o?---?----------B-?-?-?--?--M?XEo-B-T-X
XXXXXXXXXXXXXXXXXXMXXXXXXXXXXXXXXXXXXMXXXXXXXXXXXXXXXXXXXXXXXXXXXXXXXXXEXXXXXXXXXXXXXXXXXXXXXXXXXXXXXXXXX-XXXXXXXXX-XXXXXXXXXXXXXXXXXXXXXMXXXXXXXXXXXXXXXXXXXXXXXXXXXXXXXXXXXoXXoXXXXEXMXXXXXXXXXXXXXXXX
