------M-M-oo-----?----X--------B?-----B-----M--------X----------------------o------X---------E----B--------?E----M--?-----------?---?---E--M?--B-------T---------------o----X-----o---o---Eo----M----o--
--E-----?------ME------o------E-?-----B---M-----------o---------------E-o----o?E-E--------------------E--?----------T-------?--------B----o?-E------E?-E-E------E---------------o--X-?--E---------?-----
-o---------------------o--BE--?--B-?------------------------T-???-BEE-E--------------BE-----o-X---------------X---E-E--?M-M------?--E---?------X------------?--------------------E-B------------?---o-E-
----B?-------M------?-----oB----------------EX---E--o----------B--------------o----??---o-E-------B-oX----?----o-----BM-----------o--------------------------Bo-?M?----------?---?---?---?--------?--E--
---X----o------------B----??------T--B-------?---o-------?EX-----------M--E-o---------o----E----o--M-E-------------o-----B----oE----------------E-?---?------B-X-----?--------o---------------o-o-B-??--
-M-B---------?E-E-MBo---------------B-------o---E--?--EMo------B-----?-B?---oM---?------o-?-----?-----?--BE-----X--?------o?----------?ME--o?------o--B-B----X----o--E-----M----B-----oE--B--TE-MBo-----
------------------------?-----E---E---EM------?-o---E---?---------?--o-----------E---o------------------B-??--?E---------M-----M-----T------o----------o------------o-------EM--B-o----------E-----B--o-
-------o?---------?---B----------------M----B-?-?--o-----?B----o-----------TB---------TB---oE--------------EE----o--------------E--o----------M--E-------E-o--------E------?--B---B?------??M-----Bo--Bv
---o------??---oo------------------X----------B--------E-M---M-----?B---?-M--?-----o??---?----o-----?---------?-------E--?----?-o--?----M--?---------EE----M---E--?---------o---?---oB---?E---------oE-f
----B?-E----B-E--B--B-o-o---------------------B--------E-E---o--?---B--Mo-------?----o-M----------o----------E------o-----T--o-------MMM--o-----?-------------------E----M---oB-------o---?-----?---E-of
-X----------M-----------E--?B?--o---o----B-----X-----?----?----E-----E--M------M----------?M---------M-------------?-E----X--?-----------o-----------E--------?-----------oE---E-o------------B?-------f
-------B------?-----------?Bo--?---------E------o-E----o------BX-o--B--E--------o-------M------EB-?---E----------B------E----------B--Bo--------?o-B--ME---?-------E------?-?---M--B----------o-----o--f
-o-B-oMo--------------------------------o---M---------------?---B---E----o--oE----X--------o-o-----------EM--B-M----------?----B-M-E---------------?---M------B------M--?-----EX----------B---E----E---f
----o--B------E----?B--E?------E-------o-M----E--E-?----EE---------B----------?-oBBE-----------------------E---E-o--?-----B------?---E---------?-------------------Bo---M-------E-------?E--o-B--oE----f
m---?---B-?-X-?--B------?-B--T-----EE--BE----?-----B--oB--?---E-?-o--------B?---B-----B--E--?----B---?-T-B--------E-------?---??--?-E?-oX------------E-B-Bo----?--?---?-----B----B-?-?-?--?---?-Eo-B-T-X
XXXXXXXXXXXXXXXXXXMXXXXXXXXXXXXXXXXXXMXXXXXXXXXXXXXXXXXXXXXXXXXXMXXXXXXEXXXXXXXXXXXXXXXXXXXXXXXXXXXXoXXXXXXXXXXXXXXXXXXXXXXXXXXXXXXXXXXXXXXXXXXXXXXXXXXXXXXXXXXXXXXXXXXXXXXXXoXXoXXXXEXXXXXXXXXXXXoXXXXX
