-M?-oEMo--TXo-?M-T?E?o?E-?-B?--o--?BoBBoB--?M-?oE-X-?EM-EoB?o-o--o-o-oE-?---o--EoEM-o-?o?EB-E--?o?--Bo?EBM-EXoEEM?To?----?-EoBBB-o-?--E-B???E?EEB--E--M---EB??TBBEo-Bo-o-B?o-o?-E-EB-?-?--oE?E-MM-----M-
---E--o?--oo--E--o--o?E-XoMX?-??--MoE-Eo?EM-M?-BE-EB--BB?-B--BMT?--?B--B-oo-EB-?--B--BE?o-E-??-oo--ooM-?o--?E--M?B?--?---o-o-?-o-o-o?EBoE-?----?--?MoXE--B--B--BBoo--E-M-oEX-------BE?E?oo-o-?M--TBBM---
--EE-ME--o-o?-E-o-B?-oo?B??-------B-?XE-?--M?---o?M---o-M-BBEE-E-o?o-?B???B?o-oX--E-o?oE-o?E???-o-E-BMEEo?-BBE--M--?----T?ooMo-oM----oXMT?TB---EM---?E-E--EooE-BE---o??-oEE?Eoo?-oo?B-?--E?o?--o-oo??oo-
-B---?T??X-B--Mo?E-EMoBBM-?BB?-?E-Eo-E?Eo-?-Eoooo?X--o?-?EoM-?o---?BoB-?--ooE-M--oE?-?EE-Eo-E-X?-oB-M?-?B--oMEEo-?-Eo--XoB-B------T-E-MB-B-?-X?--?B?Bo??--o-E--oE-oX--B-M-?-EX?-B-?o-B--EB-MM--T-?-BE---
-o??X--BEXE?-Xo?EME?-?--MTB-?E-oE-Bo-Eo-?B-E--oMo---?TE-BE----o-?--E?E?B-MoBBM-MEE--?EE--Boo-------??MMoE---?-??--E?BE??E--o?oM-?EBM-B?--oE--?--MB??-MB--EB--EEMMo----?---B?E?--E?o?M-o-?B-E??E?oE-MXE--
-M?ooEBBoo--E-E---?-B--o--E-T--oEEXoooE--E?-E-B-XEE-EEE-----oXoM---oB---E-o-?E-E-???BE-E-o?-EoBEB?--?-E-?MoXB-M--oE--EB---?B---?E?-?-oMB--E-?XoE-?--??BBEoo-E--?BB?Bo?-oE?-Eo?-oT-----o?-?-E--MT-EB-B?M-
--EB-EE?EB-?-o?E-XMXEMEXo---B?-M?--oX?o?-M-EBMo?-??o-T-B?ToooBX?B--??--?-MEE?--M?-BM-?E?---o?B?---M-o??-XE-E-TE-o?X-oEB-EBX-E?o-X--E?-?o?E?-?-o-oo-?----EBE--E-E-Bo--o-??--BMoE-o?o-M-?-X------B--EoT---
--B-Eoo?-MB-?oB-o-TBB---E-EM-----?E-M-E-M-EE-B---B??---?-?-?M--?o?oB-?B--?E-MBE---Mo-?XM--E-?o-M-E--?E-?--B?o??-BM-oME?B?--EEMME?-B?-B-M-Bo-?--B-B-?-EM?o?B?o--BBE?M?--BEXE-BEE-?--o--M--X?-M?BB--MB-o-v
--EMEEoE-??-EMMoX----ooE-EMEo--X---o?XoBT-E-?--B?-?--EX?-o---MM-EB?-M-?o-??-E--?oEE?-E?-E-o-o-EX?--B-E--EBBB-B--o-X?EM-?-EX---Bo----?-----o--M-B-?---E---o?E?B?-oEE?XEM?-M---?Eo--?X?Eo----oMX----X?BMEf
-Bo----o-BB?oo??--?--E--B?---?X-M?B-M?E---M------o?BTo-MMoBo---E--E---BE-oBEB-MB--E--?--oBo?EM??-M--E--E--E?Eoo?---EXX?X-?o-B--ooBT?--EX?B?oEM--MoX-M??---M----M-?EEMo-B-?-?EM-o--E-EET-?oB?-EB-o?M-EEEf
-MMM-E???-E-EMB?-o?--oB--Mo--ooX----EEM?-?-M??--BEXE-?EE-ME--?B----M--?X--?---o-?-o?MoB?-MEB------??-X-?-B?-?--M?-?--MMX--EMMXB-------oEEo--?ME-X--?-oM-?Eo?-??----o-E-M-oM-?oTE?-B----BT--o-E--EM-BTBTf
--TEoM--??Eo--?-X-M---Bo----E?B-o?-EBXM-?-X-B?o?EXB-?EXo?---o---X-o?BBE?o-EM-EBE-BB--?-Eoo?-?E?--B-oEM-oMEo--BEEEX---Mo-B-TB-?-oEE-BoBMT-EE--B-?-Eo---E-?E-oEB???-M-?-E-E-?-Bo?----E--EoE-EE??oEoo?-B-Mf
-M-B?BE-?E-----BE-ME??-BE-?o??oXT?o??MTo?E-o?oBo--?-?MMo-E-?E-M-B-??EE???TMoo-?-o-oEX-oo--B?o?---?E--E-E?-o-EoT-E-?B-E-o---o--E?--E----??BX?oo-o-o---E??EEEoooBEoBMo----B--M?M-ET-M-oB?o---M-oM-B-?-?-of
-?-EoEoE??o?--TBE-E-BB-?oE-?ETEME-o-B--?B-?-BM-TEM--o--B???E--o--E-BE--BBoEB-?oEXE-M--B-??E-EoXoo-M-B?-?E-?E-?oM?-?E--TEB---?B-E?M-oB---MBBo---MoooE?-?X?o---BE--MBBMoE?-E?--E-?---E--BEEo-Too-BMM-o?--f
mB?-EXBB?BMoMoBoE?-M--oo---oE-BM-MTEB??T-??ET?---???-EE-E-?BE-XXoEEMB-BE-o-o?BB-o?o?MX--B-EM?-oBEEEo---?o?E-o-ooBE-?E?---E?-o--E?B--BB-Bo-E?--MB-M-Eo-X-o-B?-B?--?-E?-MBB?-oo-MM--B?B-?B-TBBoT-E-?MB-M-X
XXXXXXXXXXXXXXXXXXXXXXXXXXXXXXXXXXXXXXXXXXXXXXXXXXXXXXXXXXXXXoXXXXXXXXXXXXXXXXXXXXXXXXXXXXXXXXXXXXXXMX-XXXXXXXXXXXXXXXXXXXXXXXXXXXXXXXXXXXXXXXXoXXXXXXXXXXXXXXXXXXXXXXXXXXXXMXXXXXXXXXXXXXXXXXXXXXXXXXXX
