--E?---------o-------?-o-?----E--M--EM------------------B---------o-o--?-?-?---------------T---------------?-E-B----?------B---------------------M-?----------?--------E-----------B-----------?-o---EX-
--------E---B--?E---o--B----M-------B--B-o------------------M--B----Bo--o--------E----------------o-----X-----------------X-----------?------X---------?BEM-------?E------TM---------X----B-------------
-----M---------?o---o-----?-----o----------T------?----o----------------B---?-------ME-?-?------------------E------?--BB---------T-?-------E-----------EE--o---?-----------------M---------Eo----?------
-X----E---E----E----------?M--??-Bo-----B-X-----------B-o--E----------E---E-B?------E--?---------?--E----------E------------------------?----------------?--o----------o---o-EM-?--B---------o----------
-M-E----------?--B-?--------------------?o--o------XEo-?---B-X-E----o-------E-----o--?---------------------M------------E-------TX-----?--o--E---------------B?----B-?---M---?------?----o--------E-----
----E--M-ET-E--EB-----------B------B---E------B--------?----------X---X-------------BE--B---------------E-B?----E--?-M?--------------o----?------T---------B--E------E-------E--?--------------E--------
-?E-?-?--------?----?---?---o--Eo---?---?MT-------EE---XM--E--------------o----------M-----------------?-------------B---------?------------EE--E-------------o-o---------?-------------?---------------
------?---MBB------E-E---------?-----------------------X-------X--?------BXB-------------E-----------E--B--B--o--------B-?---------------------BE----?-----------?------------------E--B------o-----?--v
--------------------?--T---------?-------o-----BB-----E-----------E-----o-E--?--o----------?-------?-?-?-------------------B---------o------M------------o-------------X-B-----?------Bo---------------f
-----E----------o-----B---o-------------------E----T----------------B---B-------?--------E-?-------------------------------------X-----?-E--?---------------o--E-oM-----B?---o----o-----------E-------?f
----o-o------E-------------------?------------o--------T---------?-X-M---------------o-------oME--------------M---------E----------B-----------?-----B-o--------B?----------------M--o------EB-------T-f
---------X----------------------o---?---o-----E--?-------E------E---------Mo-----------------oo---B-M-------o----?-------------MB------oM-o-M---o---M------EE-T--B--------?-------------E------E------?f
-oX----?---X---BE--------?--E-----------------------o-----------------------------B------Eo---------o-------B-------------?-------?----M----?---M-------B--E-------------------?------------?-B-------Bf
-------B-----E--------E-----M-----??o-----EM--o----------o----------------------o----E------EE-M-------T-o----o-------M--------?-----o-EX-------------------?---TB---------------B---------B-B-?-------f
m-?-----B---B-----XE-------M-B-B----------B------------?-----T------B--o---------T-------o-------??-M---?----------BE-----------B---?---?----E---B--------M------?--------B----E-o---?-MB--B--X--------X
XXXXXXXXXXXXXXXXXXXXXXXXXXXXXXXXXXXXXXXXXXXXXXXXXXXXXXXXXXXXXXXXXXXXXXXXXXXXXXXXXXXXXXXXXXXXXXXXXXXXXXXXXXXXXXXXXXXXXXXXXXXXXXXXXXXXXXXXXXXXXXXXXXXXXXXXXXXXXXXXXXXXXXXXXXXXXXXXXXXXXXXXXXXXXXXXXXXXXXXX
