------M---oo-----?------X------B?--------------------X---------?E-----B-----o----B----X------E----B--------?-----M--?-----------?---?---M------B------o--o-------------o----X-----o---o---E-----M----o--
--E-----?----E-ME----------?--E-------B-oBM-----------------------------o----o-E-E--------M-----------E---B---------T-------?--------B----?--E------E?-E-E------E---------------o--X-?--E------o--?-----
-o----------------E-------BE--?--B-?--------------o-----------???-BEE-E--------------BE-----o-X---------------X---E-E---M-M------?--E-------o--XB------------T-------------------E-B----------------o-E-
----B?-------M------?-----oB-E--------------EX---E-----------------M----------o----??---o---------B-oX----?----o------M---o-------o--E------------------?-E--oo-?M?----------?---?---?---?--------?--E--
---X----o-----------------?--E----T--B-------?---o--------EX--?o-------M--E-o---------o----E----o--M-E---B---------o-?------E-oE----------------E-?-----------M------?-----o--o---------------o-o-B-??--
-M-B---------?E-E-MBo-----------M---B-------o---E--?--EM--M----B-----?--?----M----------o-?-----?-----?---------X--?------o?-o--------E----o?-----------B---------o--E-----M----BE----oE--B--TE-MBo-----
------------------------?-----E---E----M------?-o---E---?---------?--o----------------oX------B---------B-??--?E------E-?M----?M-----T-----------------o------------o-------EM--B-o----------E-----B--o-
-------o?---------?---B----------------M----B-?-?--oM----?B----o------------B---------TB---oE--------------ME----o--------------E--o-------------E-?----ME-o-B-o-----------?--B---B?-------?M-----Bo--Bv
---o------??---oo------------------X----------B----X---E-M---M----B?BB----M--?------?---------o-----?---------?-------E--?----?-o--?----MB-?---------EEBo--M------?------?--o-o-?---oB---?EM---------E-f
---MB?-E----B---?B--B-o-o----EE-------o-------B--o-----E-E---oo-?-o-----o-------?---?o------------o----------E------o-----T--o-------MM--------B-------E------------E----M---oB-------o-----E---?---E-of
-X----------M---?----?--E--?B---o---o----B-----X----E?----?----E-----E--M--------------B--?M---------M------------E?------X--?-----------o------M--E----------------------oE---E--------------B?-------f
-------B------?-E---------?Bo------------E----B-o-E---B-------BX-?--B--E------------------?----EB-?---E----------B--------------------B----------o-B--M----?E-------------?-?---M--B----------o--------f
-o-B-oMo--------B---------------M-------o---M---------------?---B---E----o--o-X------------o-o---?-------EM--B-M-----o----?------M-E---------------?---M------o------M--?-----E-----------B---E----E---f
----o--B------E-----B--E?---E--E-----X-o-M----E--E-?----E----------B--------------BE---B-----------------------E-o--?-----B------?---E-X---?---?--------M---------------M-------E-------?E--o-B--oE----f
m---?-----?-X-?--B------?-B--T-----EE--BE----?-----B--oB?-?---E-?-o-B-o---?B----B-----B-EE--?----B---?---B--------E-------?---??--?-E?-oX------------E-B-B-----?--?---?-----B----B-?-?-?--?---?-Eo-B-T-X
XXXXXXXXXXXXXXXXXXMXXXXXXXXXXXXXXXXXXMXXXXXXXXXXXXXXXXXXXXXXXXXXXoXXXXXEXXXXXXXXXXXXXXXXXXXXXXXXXXXXoXXXXXXXXXXXXXXXXXXXXXXXXXXXXXXXXXXXXMXXXXXXXXXXXXXXXXXXXXXXXXXXXXXXXXXXXoXXoXXXXEXXXXXXXXXXXXoXXXXX
