------------E------o----Eo-------E--B---?---B--B---?---E------------E----?----------------E---------?-------------?---------------T---X-?--------------B---------------------------------------------E--
-----E--B---------?-------??---E-----o--?----o--M?------o-----Eoo---------?E----X-?--------B---?-B-----------M----o------B-?-M---M--------T----------?----?E------------M-------MB-----o--------B-------
--M------o---------------o---o----------------?---------------------ME---Xo----o--EM-------B-E------E----------XE--------B--BE--B------------------?------o-----------B----o------o-------B--o----------
---------------------T-?-o------------------------B-------o--------------o-------o--------------TE--M-----------------------------E------o--------------?------o-------------?-o------M-?---------------
---?------------o--M-o-------?------?E-----E-?-----X------?-------o-?-B-------Eo------------------------?-----?--o---B-----------B---o-------?-B--B--?---ET--E-----------?-------------B-----------X----
----B--o-------------o?--?--------X-E-------B----------E--B---o-E--M-----E---------?----E--E-E-------------E??o---------------B----?--E------B-----------E--E-------o----o-----E-----MBE----------------
-----E----------B---E-------o-?-----o--o----?o---------?-------------------M-------?-------------------------?-------o----------------o-E----------------M----T-------o-E-----o------MoB---B------------
-----------?----------?-----------?---------B----E--B-T---------o-X-?----------M---------E---------T?------E------o-E--------B-M--Xo---M-----Eo----------?----o----B-------------??o---?--B--?E-----E--v
----B-----------?----o---B-----------------?-o-o--B-?o-------?-M----o--ME-E--------------------B--E--?-------------Bo-----B--M-X-------E----BE-------o--------------------------o------o-?----o--------f
-M--------M----o----------------oo-----E---------M-------------------------------M------o-----------E-?-------o----------------------?-----o--------ME?--EB------o-----E-----o------X---o----M-?-------f
----------E-----E-?-------------oBoo-------?-----o---?--B-------B--M---o--o-------------------------------------------E-----------o---?-?-----?-------?---E--B---------------------E-----?-M-----------f
--B---E------?-----?B-----------B----?---E---o?---------------o--------B-----?---M-----?--B--o---X-?-----------------o-----M--------?-----M----------------E------E-?---------------B?---------------B-f
----T----------------------E------------------?--B------B-o---E?------?B------?---------------------------E---?---o---------E---o?--o---------------B-----------??-----?M---------E---?-----?-E---EB-T-f
-----o--------------B--?o---X-E---?--E-----?-----T-------T-E----T--?-E-------?-?------?---------M----------------BX----E-----oT-B--o---------o---o----------------?------?--------B--------------------f
m?--?-------------T?--------------?-E------EE----B?----E----E-------M----E-----------B---------B----?-----?--?--B-------B-----?-E-To?------T-----------------------?--------B-----?MX----------?---?---X
XXXXXXXXXXXXXXXXXXXXXXXXXXXXXXXXXXXXXXXXXXXXXXXXXXXXXXXXXXXXXXXXXXXXXXXXXXXXXXXXXXXXXXXXXXXXXXXXXXXXXXXXXXXXXXXXXXXXXXXXXXXXXXXXXXXXXXXXXXXXXXXXXXXXXXXXXXXXXXXXXXXXXXXXXXXXXXXXXXXXXXXXXXXXXXXXXXXXXXXX
