-M?-oEMo--TXo-?M-T?E?o?E-?-B?--o--?-oB-oB--?M-?oE-X-?EM-EoB?o-o--o-o-oE-?---o--EoEM-o-?o?EB-EB-?o?--Bo?EBM-EXoEEM?To?----?-EoBBB-o-?--E-B???E?E-B--E--M---EB??TBBEo-B--o-B?o-o?XE-EB-?-?-MoE-E-MM-------
---E--o?--oo--E-----o?E-XoMX?--?M-MoE-Eo?EM-M?-BE-EB--BB?-B-TBMT?--?B--B-oo-EB-?--B--B-?o-E-??-oo--ooM-?o--?E--M?B?--?---o-o-?-o-o-o?EBoE-?----?--?MoXE--B--B--BBoo--E-M-oEX-------BE?E?oo-o-?---TBBMoE-
--EE-ME--o-o?-E-o-B?-oo?B??--o----B-?X--?--M?---o?M---o-M-BBEE-E-o?o-?B?-?B?o-oX----o?o--o?E???-o-E-BMEEo?EBBE--M--?----T?ooMo-o---E-oXMT?TB-o-EM---?E-E--EooE-BE---o??-oEE?Eoo?-oo?B-?---?o---o-oo-?o--
-B---?T??X-B--Mo?E-EMoBBM-?BBEX?-?Eo-E-Eo-?-Eoooo?X--o?-?EoM-?o----BoB-??-ooE-M--oE?-?E--Eo-E-X?-oB-M?-?B--oMEEo-?-Eo--XoB-B------T-E-MB-B-?-X?--?B?Bo??--o-E--oE-oX--B-M-?-EX?-B-?o-B--EB-M---T--?BE---
-o??X--BEXE?-Xo?EME?-?--MTB-?--oE-Bo-Eo-?B-E--oMo---?TE-BE----o-?--E?E?B-MoBBM-MEE--?EE--B-o-------??MM-E---?-??--E?B-??E--o?-T-?EBM-B?--oE--?--MB??-MBE-EB--EEMMo----?---B?E?--E?o?M-o-?BoE??-?oE-MXE--
-M?ooEBBoo--E-E---?-B--o-BE-T?-oEEXoooE--E?-E-B-X-E-EEE-----oXoM---oB---E-o-?E-E-???BE-E-o?-EoBEB?--?-E-?MoXB-M-o-E-BEB---?B---?E?-?-oMB--EB?XoE-?B-??BBEoo-E--?BB?Bo??oE?XEo?BoT-----o?-?BE---ToEB?B-M-
--EB-EE?EB-?-o?E-XMXEMEXo---B??M?--EX?-?-M-EBMo?-??o-T-B-ToooBX?B--??--?-MEE?--M?-BM-?E?----?B?---M-o??-XE-E-TE-o?X-oEB-EBX-E?o-X--E?-?o?E?-?-o-oo-?----EBE--E-E-Bo--o-??---MoE-o?o-M-?-X------B-EEoT-E-
--B-Eoo?-MB-?oB-o-TBB---E-EM-BE--?E-M-E-M-EE-B---B??---?-?-?M-o?o?oB-?B--?E-MBE---Mo-?XM--E-?o-M-E-E?E-?--B?o??-BM-oME?B?--EEMME?-B?-B-M-BoB?--BB--?-EM?o?-?o--BBE?M---BEXE--EE-?--o--M--X?--?BB--ME-o-v
--EMEE-E-??-EMMoX--B-ooE-EMEo-?o---o?XoBT-E-?--B?-?--EX?-o----M-EB?-M-?o-??-E--?oEE?--?-E-o-o-EX?----E---BBB-B--o-X??M-?--X-B-Bo----?B----o--M-B-?---E---o?E?B?-oEE?XEM?-M?--?Eo--?X?Eo----oMX---?X?BM-f
-Bo--?-o-BB?oo??--?--E?-B?------M?--M?E---M------o?BTo-MMoBo---E-EE-?-BE-oBEB-MB--E--?--oBo?EM??-Mo--?-E--E?Eoo?---EXX?X-?o-B--ooBT?--EX?B?oEM--MoX-M??---M----M-?EEMo-B-?-?EM-oo-E-EET-?-B?MEB-o?M-EEEf
-MMM-E???-E-EMBo-o?--oB--Mo--ooX----EEM?-?--??--BEXE-?EE-M--E?B----M-E?X------o-?-o?MoB--MEB-o---o??---?-B?-?--M?-?--MMX--EMMXB?------oEEo--?ME-X--?-oM-?Eo?-??----o---M-oM-?oTE?-B----BT--o?E-EEM-BTBTf
--TEoM--??Eo--?-X?M---Bo------BM-?-EB-B-?-X-B?o?EXB-?EXo?---o---X-o?BB-?o-EM-EBE-BB-B?-Eoo?-?E?--B-oEM-oMEo--BEEEX---Mo-BMTB-?-oEE-BoBMT-EE--B-?-Eo---E-??-oEB???-M-?-E-E-?-Bo?----E--EoE--E??oEoo?-BTof
-M-B?BE-?E-----BEEME??-BE-?o?-oXT-o--MTo?E-o?oBo-E?-?MMo-E-?E-M-B-??EE???TMoo-?-o-oEX-oo--B?-E---?E--EXE?-o-EoT-E??B-E-o---o--E?--E----??BX?oo-o-o---E??EEEoooBEoBMo----B--M?M-ET-M-EB?o---M-oM-B-?-?-of
-?-EoEoE??o?o-T-E-EBBB-?oE-?E?EME-o-BB-?B-??-M-TEM--o--B???E--o--E-BE--BBoEB-?oEXE-M--B-??E-EoXoo-M-B?E?E-?E-?oM?-?E--TEB---?B--?M-oB---MBBo--oMoooE?-?X?o-o-BE--MBBMoE?-E?--E-?---E--BEEo--oo-BMM-o-M-f
mB?-EXBB?BMoMoBoE?-M--oo-E-oE?BM-MT-B??T-??ET?---???MEE-E-?BE-XXoEEMB-BE-o-o?BB-o?o?MX--B-EM?-oBEEEoB--?o?Eoo-ooBE-?E?---E?-oE-E?B--BB-Bo-??--MB-M-Eo-X-o-B?-B?-o?-E?-MBB?-oo-MM--B?B-?B-TBBoT---?-B-M-X
XXXXXXXXXXXXXXXXXXXXXXXXXXXXXXXXXXXXXXXXXXXXXXXXXXXXXXXXXXXXXoXXXXXXXXXXXXXXXXXXXXXXXXXXXXXX-XXXXXXXMX-XXXXXXXXXXXXXXXXXXXXXXXXXXXXXXXXXXXXXXXXoXXXXXXXXXXXXXXXXXXXXXXXXXXXXMXXXXXXXXXXXXXXXXXXXXXXXXXXX
