-----------------?-o----Eo-------E-----E-XE-----------------------M?-o-----------MM-----------------?-------------?---------------------------------B--B--------?-------?-B-----------------X----?------
-----E------E-----?-------??---------o---E-------------BB-----B--------------E-?--T--------B---?-B----------?ME---o------B-?-----M--------T--------o-?----?E-?---?-----E-------------------------?------
--M----------------------o?-EoM--o-------??-B-T---------?--M?------?---BoM--------EM-------B-E--B---E----------X--------EB-------------------------?---------?-----o---?-B----------E--BM-------?-------
---------------------T---o--?-----------------o---------E------E----------E------M-------E------TE--M---------E-------------------E------o-------E------?-----------------------o------XE---------B-T---
---??----------------o-------?-------E-------E------------?---EoEo----------?---o-----------------------?------------------------B---o------------B--?---ET-B-----------X-----E--------E---M----------?-
-------o-E-----------o?--?-T--------E----o---B-E---------?---------------M-o-------?----E--E-E-------------E-Xo---------------B----?---------B--E--------E----------B?B-----------------------?---------
---o-E----------B---E-------o----------o---------BE-----E--?--?-?-----------?-?-XB-?--------M----?-------------o-----o----------------o-E----------o-----M--B-?------------B------o------------??-----?-
----?------?---------E?-----------?-------B-B----E-----E--------Mo---?-----------E-----o-E---------T?-------------o-E--------B-M--Xo---M------o----------?-B-------o----B----o----------E-o?----o----T-v
----B-----------?----o---B--------------o?----------------E--------------------B---------------B--E-T---------------------B--M-X-------E---oB--------o---E---------B-------------------------------E--Bf
-M------------oo--------o--------o-----E-----E----------E-X-B-?----??----M---------------------B----E-?-------oE----------o-------B--?-B---o--E-------?-oEB-------B---X--B---?o-???--?----T----MoT-----f
----------E-------------------o-o-oo?--------EB-----o----M-------?---E--------EB--------------------------------------E-----------o----o--------------?------------------------------------------EE--M-f
--B---E------?-----?B-----------B----?-------------------E--E--------o--o--------------??-B--o-----?-----------------o-----M--------?-----M----E-----------E----M------E-?-------?------------M--------f
----T------X------B--------E-------------E---o---E------------E-------------M-----------------------------E-M-?---o-------------o---o------M---------o-----------X----B----?--E-------------o-----E-T--f
-----o-------------EB--?----X-E---?--E-o-------o-?--------------oB?-----oB--?---------?--------------------------?X----E----B-T-B------------o---o---------oE--M-------------------?--EE----M---------of
m?B-?-----------BB-?M-------------?----------E---X---------X------------?-----?------B--B------B----------?--?--BE------B-----?-E---?-E----T-B------?-----------o----------?--------o--MB-------o??o---X
XXXXXXXXXXXXXXXXXXXXXXXXXXXXXXXXXXXXXXXXXXXXXXXXXXXXXXXXXXXXXXXXXXXXXXXXXXXXXXXXXXXXXXXXXXXXXXXXXXXXXXXXXXXXXXXXXXXXXXXXXXXXXXXXXXXXXXXXXXXXXXXXXXXXXXXXXXXXXXXXXXXXXXXXXXXXXXXXXXXXXXXXXXXXXXXXXXXXXXXX
