-------o-----------o----Eo-----?-E----B-?----------?---E-E----------E-------------------------------?-------------?------------------?-----------------B----------------------------?--------E----------
-----E------------?-------??---------o----------M?--------------oo--------?E--M-X----------Bo-??XB-------o---M----o---X--B-?-----M-----o--T-------o--?----?E--E---------M-------M---?--o--------B-------
--M----------------------o---o----------o----------------------?----ME---Xo---Bo---M-------B-E-----?E--------E-X---T-----B--X-----------------?----?------------------B-------------------B--oT---------
------------B--------T---o------------------------B----------------------o-------o--------------TE--M-----------------M-----------E------o--------------?------o-------------?-?------M-?----------?----
---?-----------------o-------?-------E-------------X------?-------o-?-----o----oX-----------------------?----E-T-----------------B---o------------B--?---ET--E-----------?-------------B?----------X----
-------o----------?--o?--?----------E------------------E--B---?-E--M------X-----?o-??---E--E-E-------------E-?o---------------B----?---------B--B-?------E--E----M--o----------------M-E---------o---E--
-----E---------oB--oE-------o----------o-----o----M----?-------?------?---MM---o-o-?---------------------------------o----?-o---------o-E----------------M----T-------o-E-----o--------------E----------
------o---??----------?-----------?---------B----E----T---------o-X-?----------M---------E---o-----T?-------------o-E-?------B-M--Xo---M------oE-------?-?----o------------E------?--o-??----?E-----E--v
----B--o--------?----o---B-----------o----------B-B----------?---------ME----------------------B--E-----------------------B--M-X-------E----B--------o---------------------o-------------?-------?o----f
-M-------------o-----------------o-----E---------M---------------E----------M----M------------------E-?-------o-----o?---------------?--X--o----------?--EB------o-----E---E--------X---o------?BB-----f
-?--------E---------------------o-oo----o-------oo------B--------------o?-o----------------------------------o--------E-----------o-------------------?--E---B----E----------------------?-M-----------f
-EB-?-E------?-----?B--------?--B----?-----E-oE-------??------o-----E--B-B---?---M-----?--B--o-----?-----------------o---?-M-?-----??-M-M-M----------------E------E-?----------------?---------------B-f
-?--T---o----?------E--?---E--------------o---?--B-------oo----?------?B------?-----------------?---?-----E---?---o------B------o---o-------------o------E------??----o?--------------?-----------E----f
-----o--------------B--?----X-E-B-?-oE-----?-?-----------T-E----T--?-E---M-----?M-----?---------------------------X----E---o--T-B------------o---o----------------?------?-----------------------------f
m?--?--------------?------------?-?---?----EE----B?----E---EE-------M----E-----------B-E-------B--------X-?--?--B-------B-----?-E---?-M----T--------------------------------B-----?-X-X--------?---?---X
XXXXXXXXXXXXXXXXXXXXXXXXXXXXXXXXXXXXXXXXXXXXXXXXXXXXXXXXXXXXXXXXXXXXXXXXXXXXXXXXXXXXXXXXXXXXXXXXXXXXXXXXXXXXXXXXXXXXXXXXXXXXXXXXXXXXXXXXXXXXXXXXXXXXXXXXXXXXXXXXXXXXXXXXXXXXXXXXXXXXXXXXXXXoXXXXXXXXXXXX
