------M---oo-----?-------------B?-----B-----M--------X----------------------o------X---------E----B--------?-----M--?-------B---?---?---E--M?--B-------T---------------o----X-----o---o---E-----M----o--
--E-----?------ME------o------E-------B---M---------------------------E-o----o?E-E------E-------------E--?-----o----T-------?--------B----o--E------E?-E-E------E---------------o--X-?--E---------?-----
-o---------------------o--BE--?--B-?------------------------T-???-BEE-E--------------BE-----o-X-------------------E-E?-?M-M------?--E---?------X------------?--------------------E-B------------?---o-E-
----B?-------M------?-----oB----------------EX---E--o-------------------------o----??---o-E-------B-oX----?----o-----BM-----------o--------------------------Bo-?M?----------?---?---?---?--------?--E--
---X----o------------B----??------T--B-------?---o-------?EXo----------M--E-o---------o----E----o--M-E-------------o----------oE----------------E-?---?-----?B-------?--------o---------------o-o-B-??--
-M-B---------?E-E-MBo---------------B?-----?o---E--?--EMo----?-B-----?-B?----M----------o-?-----?-----?--BE----Eo--?------o?----------EME--o?------o--B-B----X----o--E-----M----B-----oE--B--TE-MBo-----
------------------------?-----E---E---EM------?-o---E---?---------?--o-----------E---o------------------B-??---E---------M-----M-----T------o----------o------------o-------EM--B-o----------E-----B--o-
-------o?---------?---B----B-----------M----B-?-?--o-----?B----o-----------TB---------TB---oE--------------E-----o--------------E--o----------M--E-------E-o--------E------?--B---B?------o?M-----Bo--Bv
---o------??---oo------------------X----------B--------E-ME--M-----?B---?-M--?-----o??---?----o-----?-----------------E--?----?-o--?----M--?---------EE----M---E--?---------o---?---oB---?E----------E-f
----B?-E----B-E--B--B-o-o---------------------B--------E-E---o--?---B--Mo-------?----o-M-------?-?o----------E----E-o-----T--o-------MMM--o-------------------------E----M---oB-------o---?-----?---E-of
-X----------M-----------E--?B?--o---o----B-----X-----?----?----E-----E--M------M----------?M---------M-------------?-E----X--?-----------o-----------E----?---?---------?-oE---E--------------B?-------f
-------B------?-----------?Bo------------E------o-E-----------BX-o--B--E--------o-------M------EB-?---E----------B------E-------------Bo--------?o-B--ME---?-------E?-----?-?---M--B----------o--------f
-o-B-oMo--?-----------------------------o---M---------------?---B---E----o--o-----X--------o-o---E-------EM--B-M----------?----B-M-E---------------?---M------B--E---M--?-----E-----------B---E----E---f
----o--B------E-----B--E?------E-------o-M----E--E-?----EE---E-----B------------o-BE-----------------------EB-------?-----B------?---E---------?--------------------o---M-------E-------?E-Eo-B--oE----f
m---?-----?-X-?--B------?-B--T-----EE--BE----?-----B--oB--?---E-?-o--------B?---B-----B--E--?----B---?-T-B--o-----E-------?---??--?-E?-oX----X-------E-B-Bo----?--?---?-----B----B-?-?-?--?---?-Eo-B-T-X
XXXXXXXXXXXXXXXXXXMXXXXXXXXXXXXXXXXXXMXXXXXXXXXXXXXXXXXXXXXXXXXXMXXXXXXEXXXXXXXXXXXXXXXXXXXXXXXXXXXXXXXXXXXXXXXXXXXXXXXXXXXXXXXXXXXXXXXXXXXXXXXXXXXXXXXXXXXXXXXXXXXXXXXXXXXXXoXXoXXXXEXXXXXXXXXXXXoXXXXX
