------M---oo-----?-------------B?--------------------X---------?E-----B-----o----B----X------E----B--------?---?-M--?-----------?----o--ME-----B-?----o---------o------o----X-----o---o---E-----M----o--
--E-----?------ME------o------E-------B---M-----------------------------o----o-E-E--------M-M---------E--------o----T-------?--------B----?--E------E?-E-E------E-----------E------X-?--E------o--?-----
-o---------------------o--BE--?--B-?--------------------------???-BEE-E---?----------BE-----o-XE------------------E-E--?M-M------?--E----------XB------o-----T----------E--------E-B----M-----------o-E-
----B?-------M------?-----oB----------------EX---E-----------------M----------o----??---o-----------oX----?----o-----BM-----------o----?----------------?----oo-?-?----------?---?---?---?--------?--E--
---X----o-----?------B----??------T--B-------?---o--------EX--?--------M--E-o---------o---------o----E-------------o----------oE----?-----------E-?-----------M------?--------o---B-----------o-o-B-??--
-M-B---------?E-E-MBo---------------B-o-----o---E--?--EM--M----B-----?--?----M----------o-?-----?--B--?--BE--?-Eo--?------o?----------E---Bo?-----------B---------o--E-----M----B-----oE--B--TE-MBo-----
------------------------?-----E---E----M------?-o---E---?---------?--o----------------oX----------------B-??---E---------M-----M----BT------o----------o------------o-------EM--B------------E-----B--o-
-------o?---------?---B----------------M----B-?-?--oM----?B----o------------B---------TB---o--E------------E-----o--o-----------E--o-------------E-?----ME-o---o-E---------?--B----?-------?M-----Bo--Bv
---o------??---oo--------------o---X----------B--------E-M---M----B?BB----M--?------?---------o-----?-------------?---E--?----?-o--?----MB-?---------EEBo--M------?---------o---?---oB---?EM---------E-f
----B?-E----B-E--B--B-o-o---------------------B--o-----E-E---o--?-o-----o-------?---?o------------o----------E------o-----TM-o------E-M--------B--------------------E----M---o--------o---------?---E-of
-X----------M-----------E--?B?--o---o----B-----X----E?----?----E-----E--M-----------------?M-B-------M---?---------?-E----X--?-----------o------M--E--------------o-------oET--E--------------B?-------f
----E--B------?-----------?Bo------------E----B-o-E---B-------BX-?--B--E------------------?-----B-?---E----------B--E---E-------B-----B----------o-B--M----?E---E-----------?------B----------o--------f
-o-B-oMo--------------------------------o---M---------------?---B---E----o--o-X------------o-------------EM--B-M----------?------M-E---------------?---M------o---------?-----E--T--------B---E----E---f
----o--B------E-----B--E?------E-------o-M----E--E-?----E----------B--------------BE---B-----------E-------E--------?--M--B------?---------?---?------------------------M--------M------?E--o-B--oE----f
m---?-----?-X-?--B------?-B-oT-----EE--BE----?-----B--oB?-?---E-?-o-B-----?B----B-----B-EE--?----B---?-T-B--------E-------?---??--?--?-oX------T-----E-B-B-----?-o?---?----------B-?-?-?--?---?-Eo-B-T-X
XXXXXXXXXXXXXXXXXXMXXXXXXXXXXXXXXXXXXMXXXXXXXXXXXXXXXXXXXXXXXXXXXoXXXXXEXXXXXXXXXXXXXXXXXXXXXXXXXXXXXXXXXXXXXXXXXXXXXXXXXXXXXXXXXXXXXXXXXMXXXXXXXXXXXXXXXXXXXXXXXXXXXXXXXXXXXoXXoXXXXEXXXXXXXXXXXXoXXXXX
