---o----?--------o----B--------------------------?---X--B--------------E------?------?X----------E---M--------BB-----------B-M---------------E------TEE--------?---B-------X--X---?-------------?-------
-----o--?----------o-?---------B?----B-----o-E-----------o--o--------o-------E-E--X------X---M---B------X---M------------------X--?--?X-----M---X--M-------E---o---?-----------B----------------o-----M-
------E----X---o----M---?---------E-----------M--------o---------------o---?---------------?---------E-----E-B-----?---B---------T-------o----o--o---B---------o----?---M--B-------------------------B--
--E?---E---------MEE-----B---E-------------?---M--?-------B---------o-E----?-o--X?---B-----E---?----B----E------M------------o-------o---B------MB-----T-E----?--E-----MM--------o---------oo---------?-
-------?--B--------B-----?------?--o--E-------------------MX??-----?oE------E-----oo--E--------?----B------M--EX-M------ET------TX-----B----E-------E----------?-----T-----o-----o---E--oT-----------o?-
-E--o--------E--E------?-----E------M----------------X----------------X--------------E-------X--E?--------B?---E-o-o-M---------------------?-----E-o-o--EB--?--------E--------------------E---?------M--
---------------o-?------B-o-----------oE--------o------XME-E----E------------------------------B-------?-------------B---------------------------E----------------------oo--?M------------o-------------
-o-------T--E----?MB--------?--------------------M-M-----------X---------?---?-------?---------------------------------o------B--------M--------------------?-----------------E----------?---?-------o-v
-E---------------EE--o-------B---E--?------------M------o------??------------BE---B-----o-------?-----E------X-?--M---B-o----B-----------?-E-?o--?--E-EE-----------BM--E--E-----??B----------------E-E-f
---oT--------E-----------B-B-----?-------E-?------------------------BE-----EE-----oE-----B---------------------------------E-----X------------o---T------------------E-----o------B---?----------------f
------?--------oB-------o----o?------??-M------------X-------E---M-X-----?-?---T------------?o----B-----------------------------?-----------------E----B-----?-----------E--E--o-----M----E------------f
--?----E-----M------E?-E-?--?BB--?B------MB-?-------M------------E-------o-----T-------?-o--B-X?--------B---o--X------------------?-----M--B--------------------B-----------------?--oE---M----?-o-----f
---?---------?--BB-B-o---------B-----o-o------E----E-------------------?o-Booo---BE------?---B------E-o-------E--------o-------------X---B------------------------?-----------ME----------------B--Mo?-f
------?-----B--------E-----B-M-------------B----o--o--------E--o-----------------------T---------------M-o---------M-?---------------o-E-X----------E--------o--------------B----?--------------------?f
m---B---------X-------?---XM--B--o----?--------E--?--BB?-----T-o-------?--o-o---------?----------------?---B-------B?o?-T------oB---------------M--X-----?--o--?-?-E---EBo---T----B---------E---?-?----X
XXXXXXXXXXXXXXXXXXXXXXXXXXXXXXXXXXXXXXXXXXXXXXXXXXXXXXXXXXXXXXXXXXXXXXXXXXXXXXXXXXXXXXXXXXXXXXXXXXXXXXXXXXXXXXXXXXXXXXXXXXXXXXXXXXXXXXXXXXXXXXXXXXXXXXXXXXXXXXXXXXXXXXXXXXXXXXXXXXXXXXXXXXXXXXXXXXXXXXXX
