--------?----E-------------------------------------E-X--B--E-M----?--------?------------------o----------------B-----------B---------------B?-?-------------?o----oB----o--X-o-------E--T---?---?-------
-?------E-----------------------o-ooo-------------EB----B---M--------o-----------E----------------o-----X------------------o----------?-X------o------------------M-Bo--------------?B------E-----------
------?-----------E----------B---------------MM--------o----------------E---?--B---------?---------------o---------?---B---------T--B------------o-------------o--------M--------B--B-------------------
-----------?---------o----------------------E--E----------------------E---E-----E-------------o--?-o--------?----------------?-?--------B--------B--o---------?--E-o----ME--------E--------o------------
---M-M--BE--To-o---M---E-------------------o------------------------oB------------------------------o------M----?-------E--T----TXE----B-------?-------------------o-------BM----E---E------------------
----?--E-----------B----------------E-------------------o--------o----X------X--o---B----------o---E----E-B??--------M--------------------o---------------?X--------------------------------M-?---------
------------------E-------------------E------------?----M--E---------------E--------------M-T------o---?--------E----B-------------E-------------E----------X----oE----------M--------------------------
--M----E-----M?--T---------?-----o------------B--M--------T----X-------E---B?---o---B----E--?----E---E---------------------------M-B--------------E---------------------------E--------E-------M--?--o-v
--------------E------EoM-?-----o--?-----------------Eo--------o---------o------------E-?------B----?--E--------------------E--------------B------?--B--E------E----BM--E--E-?E---?B--?-----------------f
-----E?-B----M--X---------------?--------E-?-----EB----M----B-------B----------B?----o--oE--T------M---o----X--------------------X--Mo------------B-?E----?---E------------o----------?E---------------f
----M--?-----?----------------M-------E---------------------------oX--------o-----?--o---------------M-----E--M-----------?-----------------------E-B------o-----E-------E-----o-----M------------o----f
------------------?--------?--B--X--E-o---B--------------EE-------------o--o-B--------------------B-M---E---o---E-------B---------------M------------M------?---B--------B--E-----?--------------o-----f
--?-----E--?--------B------------o---------B----B--E--o-----------E-----------------------B----oBE------------------------------------------------?---?--E-----B----B----------E---B-M-------------M-?-f
-------------B--?----------M--B------B-T--------o------M-E--------M--------------------------E-M-------?-oo-?------------M-----------o-E-X---E---------o-----o-----E-----------------------------E----Ef
m----X----?------X----------o--?-X---------?---E-???oB-?-E-?-T--T------o-------------?---o---------?---------T--M-----?---------B-----B?---?-------------?---------E---EB----T--------------E-?-?-?----X
XXXXXXXXXXXXXXXXXXXXXXXXXXXXXXXXXXXXXXXXXXXXXXXXXXXXXXXXXXXXXXXXXXXXXXXXXXXXXXXXXXXXXXXXXXXXXXXXXXXXXXXXXXXXXXXXXXXXXXXXXXXXXXXXXXXXXXXXXXXXXXXXXXXXXXXXXXXXXXXXXXXXXXXXXXXXXXXXXXXXXXXXXXXXXXXXXXXXXXXX
