-----------o----------?-E?---E-B---------------------X--B----M---------E-----X?-----------------------??------BB----E------B--------B--------E--------E------------B-------X--X---?-------------?-E-----
--------E------?-----oBB----------X---BE------?---EB----B---M--------o-------E-E--------------B---o-o-B-X---M------------B-----X-EE---?--M------B-----o--------o---?-------------BB------E----------?---
---?-------?-M----------------M---------------M--------o---------------o-------------Mo--?--B--------B-------Bo----?---B--------oT------------o--o------M------o--------M-?B------------E-?----------M--
---E--E-----M-BE--E-----M-?--------------o--E--M?-----B-M-------------E---------X----BM------E---?-------E-----------------E-o-------X---B?------B-----?-E-o--?--E----EMM--------o---?---E-o----E-?-Bo--
---E--?----------B-?------------------E--B--------------------------o-----?-------o-----?------------------M--EX-M------E-------TX-----B----E------------------?----E------o-----o---E------------------
-oE----M----E-----------E-------------M-----------------o-------------X-----E--o-----B------------B-------B?-----o-o-M--B---------M?o------?---o-E-------B----o-------M-------------o---------?-------?-
-?--?--?-----------E?-----------------o------------?----M--E-------------------------------------B---X-?----o--E-----B---------------------------EB-----M-----?---------o----M------------?---o---------
------?----B------------------------o---------B--M--------T----X---------?---??---?--?---E-----------E--E------------o------------E----M-B-------------o--???-----?o----------E-----------X-o-----T--o-v
-----?----------o-B-?-----o-------------------------E------------?--B--------------o------M----o---?--------------M----------B-E---------?-E-?o--?--E--E-----------BM--E--E-----??B-----------Bo-------f
-----E----------o-----B---o--------------E-?-----------M----E-------BE-------------E-----E---?---------BT------------------E-----X----?------------------------------------o------E---?----------------f
--T---------?-----------?---EE----------M-----B------B------o------X-----?-?---T------o--E------------E-------------E-----------?----------------?E----------?-----------E--E--o-----M---------E----?--f
------o-----------------------E------?----B--------------ME-T----E-------o-----T-----o-----E----B-B-MM------o?-------------B------------M--B--------------------B--B-------------??---E----------o-----f
-o-----------E----B------?---M-----o------------B--E--oM---------------?o-o-oo----E---E-------o----------------------------------------?-?------------------------?------------E---------M---------M-?-f
-------EE-------------------M-----------B-------o-------E--------------------------------E---E---------M?o-----B--------B------------o-E-X----------E--------o--------------B--------------B---E-------f
m-?-----B-M--------B-----?---------B-------?---E--?--B-?-E-?-T---------?--o-o---------?o----------E-E------B-------BXo?--------oB--B------------M--------?--o--?---E---EBo---T-B--B---------E---?-?----X
XXXXXXXXXXXXXXXXXXXXXXXXXXXXXXXXXXXXXXXXXXXXXXXXXXXXXXXXXXXXXXXXXXXXXXXXXXXXXXXXXXXXXXXXXXXXXXXXXXXXXXXXXXXXXXXXXXXXXXXXXXXXXXXXXXXXXXXXXXXXXXXXXXXXXXXXXXXXXXXXXXXXXXXXXXXXXXXXXXXXXXXXXXXXXXXXXXXXXXXX
