-------------------o----Eo-------E--o---?----------?---E------------E-------------------------------?--E-------?--?------------------------------------B---------------------o--------------------------
-----E--------E---?-------??-?-------o-----------?------------------------?E----X----------B-X-?-B-----------M----o------B-?-----M------o-T------B---?----?E------------M-------M------o-----o--B-------
--M----------------------o---o----------------------------------E---ME---Xo----o--EM-------B-E------E----------X---------B-------E-----------------?------------------B-------------------B--o----------
------?--------------T---o------------------------B----------------------o-------o--------------TE--M-----------------------------E-----?o--------------?----E-o-------------?-?------ME?---------------
---?--------B?-------o------B?---E-o-E-------------X--T---?-------o-?----------o------------------------?------------------------BE--o------------B--?---ET--E-----------?-------------B-----------X----
-?-----o-------------o?--?------B?--E----T------?------E--B-----E--M---------------?----E--E-E--------E----E-?o---------------B----?--?X-----B-----------E--E-?-----oB---------------M-E------B---------
-----E----------B---E-o-----o------o---o-----o---------?-------------------Mo------?--------------------B------------o------------o---o-E----------------M----T-------o-E-----o-----------------?M------
-?---------?----o-----?-----------?-M-----o-B----E----T---------o-X-?-------M--M---------E---------T?-------------o-E----?B-oB-M--Xo---M------o-T--------?----o-------------------?----?-----?E-----E-Bv
----B-----------?----o-M-B--------B-------o-------B----------?---------ME----o-----------------B--EB--------B-------------B--M-X----E--E----B--------o------X------------------o-o-------?--------?E---f
-M-------------o-------------M---o-----E---------M-------------------------------M-----E------------E-?---X--Eo----------------------?--?--o----------?--EB------o-----E--o?--------X-E-o------?-------f
--?---B---E---------------------o-ooo----B-------o------B--B-----------o--o------------------------------E------------EM----------o---------B---------?-E-?--B---------------------------?-M-----------f
--B---E------?-----?B------o----B----?-------o-------B---B----oT-E-----B-----?---M-----?--B--o-----?-B--E------------o-----M?-------?-----M----------------E------E-?-------------?--?---------------B-f
----T----------------------E------------------?-oB--------o--o-?------?B------?---------------------------E---?---o-------------o---o-------?---B---------------??--E--?--------------?-----------EB---f
----oo--------------B--?----X-E---?-EE-----?-------------T-E----T--?-E---------?------?----------E-----------E----X----E-----BT-B----E-------o---o----------------?-E----?----------M------E-----------f
m?--?--------------?--M--?--------?--o-----EE----B?----E----E-------M----E---------?-B---------B----------?--?--B---M---B-----?-E---?------T--------------------E-----------BE----?-X-?------?-?---?---X
XXXoXXXXXXXXXXXXXX?XXXXXXXXXXXXXXXXXXXXXXXXXXXXXXXXXXXXXXXXXXXXXXXXXXXXXXXXXXXXXXXXXXXXXXXXXXXXXXXXXXXXXXXXXXXXXXXXXXXXXXXXXXXXXXXXXXXXXXXXXXXXXXXXXXXXXXXXXXXXXXXXXXXXXXXXXXXXXXXXXXXXXXXXXXXXXXXXXXXXX
