-----------o----E-----?--?-----B---------------------X-MB-----------?--E-?----?-----------------------?--------B-----------B---------------B?-?-------------?o-----B----o--X--X--??------?------?-------
----E---E--o---?-----oBB-------o------BE---?------EB----B------------o-------E-E--------------B---o-o---X-------E----------?----------?-X-B---------------o---ME--M--o-B----------------------------E---
-M---------?-M-------------------------MM-----M--------o-------B-------o--------------?--?--M------EoB----?--------?E--B---------T--B------------o---------o---o--------M--------o--------?-------------
------E--------E--E-----M-?o----------------E--M----------B-----------E---------X----BM----E-E---?-?---E---------------------?-?--------B--------B------------?--E---o--ME-------o-------E-o------?-----
---E-??----------B-?---------------E--E-------------------MX??------o-----X-------o-----?-----------------EM------------E--T----TXE----B-------?---------------------------B-----o---E---M----------TE--
-------M----E------------------------------------------?o-------------X--------------E-----E--------------B?-----E---M--------------------o---------------------------------------------------?-------?-
-?--?--?-----------E?---------B-------o------------?----M--E----------------------------?-----o--B---X-?-------------B--------?-E----------------E----------X----BE----------M------E-----?------?------
------?-?--B---------------?o-------o--?------B--M--M-------B--X---------?---?-Xo----?B--E---?-------E---B--------B-------------BM-----o----------E---------o-----------------E---------------E------o-v
------------o----------?------------------?--------EE---------------------------E-----E------------?-M----------E----------E--------------B------?--B--E-----------BM--E--E-?----?B------------E-------f
-E---E----------o-----B---o----?--------EE-?-----------M------------BE-------------E-----E--M----------oB--------M--------------EX----------------B-?E----?----------------o----------?----------------f
--T---------?------------------?--------M----M---------------E-----X-----?-?---M---------E-B---?--------------------------?o------?-------BM------E----------------?-----E-?-?-o--E--M---------E-------f
------o---------?-------------E------?----B----B---------M--M----E-------o-----T------B-----E---B-B-MM---E--o-----------B--------E------M----------T----M---?---B-----------E-----?---E---------?o----Ef
-o----------------B---o--?---M-----o--?---------B--E--o----------------?oEB-oo----E---E-------o--------------?---------------M-?-----M---------o------?--E-----B----MM-----?---E---------M---------M-??f
-------EE-------------o-----Mo----------B-------oX----------E---------------------M------E---E-----------o---------------------------o-E-X-------E-----o----oo----------E------------E---B-----E------Mf
m-?--E--B-M--------B-----?-------?---------?---E--?--B-?-E---T---------?--o-o---------?o---EM-------E------o------X--B----------B-----B?---?-------------?----B----E--EEB--?-T----B---------E---?-?---?X
XXXXXXXXXXXXXXXXXXXXXXXXXXXXXXXXXXXXXXXXXXXXXXXXXXXXXXXXXXXXXXXXXXXXXXXXXXXXXXXXXXXXXXXXXXXXXXXXXXXXXXXXXXXXXXXXXXXXXXXXXXXXXXXXXXXXXXXXXXXXXXXXXXXXXXXXXXXXXXXXXXXXXXXXXXXXXXXXXXXXXXXXXXXXXXXXXXXXXXXX
