-o---------------?Mo----Eo-------E------?----------?---E--------B---E----------------?--------------?-------------?------?-----------------------------B--------------------------------------------E---
-----E-----------??----B--??------?-Eo-----------?----------------E-------?E----X----------B---?-B-----------M----o-----EB-?-----M--------T--------?-?----?E------------M-------M---o--o--------B-------
--M----------------------o---o--------------------------------------ME-o-Xo----o---M-------B-E-----?E---o------X---------B-------------------------?------------------B-------------------B--o----------
-------?-------------T---o------------------------B---------B------------o-------o---------M----TE--M-----------------------------E----B-o--------------?------o-------------?-?------MB?-----?-o-------
-o-?o---------?----E-o--E--EB?-------E-------------X------?-------o-?--E-------o------------------------?------------------------B?--o-B----------B--?---ET--E-----------?-------------B-----?-----X----
-------o-------------o?--?-B--------E------------------E--B-----E--M---------------?-B-BE--E-E-------------E-?o----------E----B---B?---------B-----------E-?E-------o----------------M-E---------X----E-
-----E----------B---E-------o-------B--o-----o---------?-------------------M-------?------------o---------------B----o------?--------Mo-E--------------E-M----T?------o-E-X---o-----------E-------------
-------?---?----------?---------E-?---------B----E--B-T---------o-X-?--------E-M--E------E---------T?-M-----------o-E--------B-M--Xo---M------o--------o-?----o-------------------?----?-----?E-----E--v
----B---E-------?----o---B-------------E----------B----------?---------ME--E---B---------------B--EE-------M--------------B--M-X-------E----BE-------o-----------------------------------?E------------f
-M-------------o-----------------o-----E---------M-------------------------------M------------------EE?-------o----------------------?-----o----------?--EB---o--o--X--E------------X---o------?-------f
------E---E--------o------------o-oo-------------o------B--------------o--o-------------------------------------------E-----------o-------------------?------B--E------------------------?-M-----------f
--B---E----E-?-----?B-----------B----?X-----Bo----------------o--------B-----?--MM-----?--B?-o-----?o--------E-------o-----M--------?-----M---------------BE---?--E-?----------------?---M-----------B-f
----T----------------------E-----------o------?--B--------o----?o-M---?B------?--------------------------?E---?---o-------------o---o---------------------M-----??-----?------------EE?-----------E----f
-----o--------------B-E?--?EX-E---?--E-----?-----?-------T-E----T--?-E---------?---M--?-------?-------------------X--M-E------T-B-----------?o---o?-----------B---?------?-------------M---------------f
m??-?---o----------?--------------?----?---EE----B?-o--E--?-E-------M----E---E-------B---------B----------?--?--B----?--B-----?-E---?------T------------------------B-------B-----?-X----------?---?---X
XXXXXXXXXXXXXXXXXXXXXXXXXXXXXXXXXXXXXXXXXXXXXXXXXXXXXXXXXXXXXXXXXXXXXXXXXXXXXXXXXXXXXXXXXXXXXXXXXXXXXXXXXXXXXXXXXXXXXXXXXXXXXXXXXXXXXXXXXXXXXXXXXXXXXXXXXXXXXXXXXXXXXXXXXXXXXXXXXXXXXXXXXXXXXXXXXXXXXXXX
