---E--M---oo-----?---------E---B?-----B-------------MX----------------------o----M-X---------E----B--------?-----M--?-----------?---?---E-?M?--B-----?-T---------------o----X-----o---o---E-----M----o--
--E-----?------ME------o------E-------B---M-------------o-----?-------E-o----o-E-E--------------------E---B----o----T-------?--------B----o--E------E?-E-E------E---------------o--X-?--EM--------?-----
-o---------------------o--BE--?--B-?------------------------T-???-BEE-E--------------BE-----o-X---------------X---E-E--?M-M------?--E---?------X------------?------------E-------E-B----------------o-E-
----B?-------M------?-----oB----------------EX---E--oE------------------------o----??---o-E-------B-oX----o----o-----BM----?------o-------B----E-------------Bo-?M?----o-----?---?---?---?--o-----X--E--
---X----o------B-----B----??------T--B-------?---o--------EX-----------M--E-o---------o--?-E----o--M-E---B---------o----------oE-E--------------E-?---?------B-------?--------o---------------oMo-B-??--
-M-B---------?E-E-MBo---------------B-------o---E--?--EM-------B-----?-B?----M----------o-?-----?-----?--------Eo--?------o?----T-----EME--o?------o--B-B----X----o--E-----M-B--B-----oE--B--TE-MBo-----
------------------------?-----E---E----M------?-o---E---?---------?--o-----------E---o------------------B-??--?E---------M-----M?----T------o----------o----?----?--o-------EM--B-o----------E-----B--o-
-----B-o?---------?---B------------o---M----B-?-?--o-----?B----o?-----------B---------TB---oE--------------ME----o--M-----------E--o-------------E-------E-o---------T-----?--B---B?-------?M-----Bo--Bv
---o------??---oo------------------X----------B--------E-M---M-----?B---?-M--?-----o??---?----o-----?---------?-------E--?----?-o--?----M--?---------EE----M---E--?---------o---?---oB---?E----------E-f
-----?-E----B-E--B--B-o-o------------------E--B--o-----E-E---o--?---B--Mo-------?----o-M----------o----------E------o-----T--o-------MMM--o-------------------------E----M---oB-------o---M-----?---E-of
-X----------M-?---------E--?B?--o---o----B-----X-----?--T-?----E-----E--M-----------------?M---------M--------?----?-B----X--?-----------o-----------E--------?-----------oE---E--------------B?-o-----f
-------B------?-------?---?Bo------------E----B-o-E-----------BX-o--B--E-------Eo-------M------EB-?---E----------B------E-------------Bo---------o-B--ME---?--------------?-?E--M--B----------o--------f
-o-B-oMo--------o-----------------------o---M---------------?---B---E----o--o-----X--------o-o--------E--EM--B-M----------?------M-E-------------o-?---M------B------M--?-----E-----------B---E----E---f
----o--B------E-----B--E?------E----B--o-M----E--E-?----EE---------B------------o-BE--------------------------------?-----B------?---E---------?---------------E--------M-------E-------?E--o-B--oE----f
mo--?-----?-X-?--B------?-B--T-----EE--BE----?-E---B--oB--?---E-?-o--------B?---B-----B--E--?----B---?---B--------E-------?---??--?-E?EoX--E---?-----E-B-Bo----?--?---?-----B----B-?-?-?--?---?-Eo-B-T-X
XXXXXXXXXXXXXXXXXXMXXXXXXXXXX-XXXXXXXMXXXXXXXXXXXXXXXXXXXXXXXXXXXXXXXXXEXXXXXXXXXXXXXXXXXXXXXXXXXXXXoXXXXXXXXXXXXXXXXXXXXXXXXXXXXXXXXXXXXXXoXXXXXXXXXXXXXXXXXXXXXXXXXXXXXXXXXoXXoXXXXEXXXXXXXXXXXXoXXXXX
