---?B--------------o---BEo-------E--E---?-----?----?---E---o--------E------?-----o---------------?--?-------------?------------------------------------B-----------B-----------?--------------------?---
-----E------------?-------??------o--o-----------?----------------B-------?E----X----E-----B---?-B-----------M----o------B-?-----M--------T----------?----?E------------M-------M------o--------B-------
--M----------------------o---o-------------o------------E-----------ME-o-Xo----o---M-------B-E------E----------X-B-o?----B------------------X----?-?------------------B-E-----------------B--o----------
---------------------T-?-o-------------o----------B------------Mo--------o-------o--------------TE-?M-----------------?-----------E------o---o-------M--?------o-M-o---------?-?------M-?-----------B---
---?-----------------o-------?-------E-------------X----X-?-------o-?---------?o-B----------------------?---------B------------E-B---o---E--------B--?---ET--E-------o---?-?------o----B---------?-X----
-----o-o-------------o?--?----------E---------------M--E--B-----E--M----M----------?---BE?-E-E?--M---------E-?o----------E----B----?--B------B-----------E-oE------Eo----------------M-E----o-----------
-----E-----o----B---E-------o----------o-----o---------?-----------------?-M-------?---------------------------------o--E-------------o-E----BE----------MM---T-------o-E-----o-------------------------
----------B?----------?-----------?--E------B---?EE---T---E-----o-X-?----------M------?--E-----X---T?-------------o-E--------BMM?-Xo---M------o----------?----o-------------------?----?-----?E-?---E--v
----B-----------?----o---B----M-------------------B----------?---------ME--------------------?-B--E-----------------------B--M-X-------E--X-B-M------o-------------B-T-----M-----E-------?-------------f
-M-------------o-----------------o----BE---------M-------------------------------M------------------EE?--oM---o--------?---?---------?B----oo-------B-?--EB?-----o-----E------------X--?o------?-------f
----------E-----o-------E------oo-oo-------------o------B--------o-----o--o------------B-----?-------B----------------E-----------o-------------------?------B--oT-----------------------?-M-----------f
--B---E-E----?-----?B-----------B----??----E-o----------------o----X---B-----?-?-M-----?--B--o-----?-------------?---o-----M--------?-----M----------------E--?---E-?-------?-----B--?----?-------T--B-f
----T---------------?------E---------------T--?--B--------o----?------?B---?--?-------o--------------o----E---?---o------------Mo---o-------B----------------E--??-----?-?------------?-----B-----E----f
-----o--------------B--?----X-E---?--E-----?-------------T-EB---T--?-E---------?-T--?-?---------------------------X----E------T-B------------o---o---E------------?----?-?-----?-----------------------f
m?--?--------------?--------------?--------EE----B?----E----E-------M----?-----B----EB------?B-B----------?--?--BB---o--B-----?-E---?------T--------------------------------B-----?-X---------??---?---X
XXXXXXXXXXXXXXXXXXXXXoXXXXXXXXXXXXXXXXXXXXXXXXXXXXXXXXXXXXXXXXXXXXXXXXXXXXXXXXXXXXXXXXXXXXXXXXXXXXXXXXXXXXXXXXXXXXXXXXXXXXXXXXXXXXXXXXXXXXXXXXXXXXXXXXXXXXXXXXXXXXXXXXXXXXXXXXXXXXXXXXXXXXXXXXXXXXXXXXXX
