-M??oEMo--TEE-?M-T?E?o?E-?-B?--o--?-oBXoB--?M--oE-X-?EM-EoB?o-o-Eo-o-oE-?---o--EoE--o-?o?EB-E-E?o?--Bo?EBM-EX-EEM?T-XE---?-EoBBB-E?-B-E-E???E?E-B--E--M---EB??TBBEo-B--o-B?o-o?-E-EB-?-?--oEoE-MMB------
---?--o?--oo--E?----o?E-XoMX??-?--MoE-Eo?EM-M??BEoEB--BB?-BE-BMT?--?-E-B-oo-EB-?-EB--B-?o-E-??-oo--ooM-?o?-?E-?M?B-E-M?EMo-o-?EoBo-o?EBEE-?---E?-??MoXE--B--B--BBoo--E-M-oEX-------BE?E?oo-o-?--BTBBMM--
-EE--ME--o-o?-E-o-B?-oo?B??--o----B-?X-o?--M?---o?M---o-M-BBEE-E-o?o-?B?-?B?oooX----o?o--o?-???-o-E-BME-o-------MB--M----?ooM--oB-E--EXMT?TB---EM---?E----Eoo--BE---o??-oEE?Eoo?-oo?B-?---?o-o-o-ooB?o--
-B---?T??X-B--Mo?E-EMoBBM-?BBEX?--Eo-E-Eo-?oEoooo?X-oo?-?EoM-?o----BoB-?--ooE-M--oE?-?E---o-E-X?-oB-M?-E-?--MEEo-?-EB-B?oB-B----M-T-E-MB---?-X?--?B?Bo??--o-E--oE-oX-BB-M-?oEX?-B-?o-B--EB-M---T?--BE---
-B??X--BEXE?-Xo?EME?-?-EMTB----oE-Bo-Eo-?B-E--o?o---?TE-BE----o-?--E?E?B-M?BBM-MEE--?EE--B-oT---o-B??MM---o-?E??-?E-?E-?E--o??T-?E-M-B?--oE--?--MB??-MB---BB-EEMMo---T?---B?E?--E?o?M-o-?BoE??-?oE-MXE--
-E?-oEBBoo--E-E---?-B--o-XE?T?MoEEXoooE--E?-E-B-XME-EEE-----oXoM---oB---EBo-?E-E-E??BE-E-o?-EoBEB?o-?-E-?MoXB-E---B-?o?B?-?M---?E?---oEB-?E-?XoE-?--??BBEoo-E--?BB?Bo?-oE?-Eo?-oT-----o?-?-E---T-EBM?-M-
-oE--EE?EB-?-o?E-XMXEMEXo---B??M?--EX?-?MMEEBMo?-??o-T-B-ToooBX?B--??--?--EE?--M?-Bo-?E?-----B?---M-o???X-oE-TE-oME---o-EBX-E?--M---?o?o?o?-?-o-oo??----EBE--E-E-Bo--o-??----oE-o?o?M-?-X-B----B-EEoT---
--B-Eoo?-MB-?oB-o-TBB-M-E-EM-BE--?E-M-E?M-Eo-B---B??---?-M-?M--?o?oB-?B--?E-MBE---Moo?XM--E-?o-M-E--?E-?o--?--?-BXo--?E?o---EMME??B-E--MEBo-?-XB-----EM?-?-?o--BBE?M---BEXE--EE-?--o--M--X?--?BB--ME-o-v
--EMEE-E-??XEM-oX-E--ooE-EMEo-?----o?XoBT-E-?--B?E?-oEX?-o----MBEB??M-?o-??-E--?oEE?--?-E-o-o-EX?--B-E----BBEB--o--?-E--E-----Bo-B--?-?-M-o--M?BE?---E---o?E?B??oEE?XEM?-M---?Eo--?X?Eoo?--oMX----X?BM-f
-Bo----o?BB?oo??--?--E-BB?------M?--M?E---M------o?BTo-MMoBo---E-BE---BE-oBEB-MB--E-??--oBo?oM??oM--?------?Eoo?---XXX-?-?o-B--ooBT----X?o?oEM--MoX-M??---M----M-?EEMo-E-?E?EM-o--E-EET-?-B?MEBMo?M-EEEf
-?M--E???-E-EMB?-o?--oB--Mo--ooX----EEM?-?-E??--BEXE-?EEBM---?B----?--?X----?-o-?-o?MoB--MEB------???--?-B?-?-oM?------E?-EMMXB-?MXBo-oXEE--?M--X--?--M-?Eo?-??---Eo---M-oM-?BTE?-B----BT--o-E-EEM-BTBTf
-?TEoM--?XEo--?BX-M---Bo------B--?-EB---?-X-B?o?EXB-?EXo?---o---X-o?BB-?o-E--EBE-BB--?-Eoo?o?E?---MoEM-oME-B-BEEXXoE?B-TBoT--?o-oEEBo-M-?BE-EB-?-Eo---E-?--oEB???-M-?-E-E??-Bo-----E--EoE--E??oEoo?-B-Mf
-M-B?BE-?-E----BE-ME??-BE-?o?-oXT-o--MTo?E-o?oBoB-?-MEMo-E-?E?M-BE??EE???TMoo-?-o-oEX-oo--B?-E---?E--E--?-o-EoX-E?---EM--o-o--E?--E??---EBX?oo-oXo---E??EEEoooBEoBMo----B---?M-ET-M-EB?o-E-M-oM-B-?-?-of
-?XEoEoE??o?B-TEE-E-BB-?oEB?E?EME-o-BB-?B-?--M-TEM--o--BB??E--o--E-BE-BBBoEB-?oEXE-Mo-B???E-EoXooBM-B???E-?EM?o-?-?--B-EB---?B--?MMoB--BE-Bo---MoooE?-?X?o---BE-MMBBMoE?-E?--E-?---E-EBEEo--oo-BMM-o-M-f
mB?-EXB-?BMoMoBoE?-M--oo---oE?BM-MT-B??T-??ET-X-o?T?-EE----BE-XXoEEMB-BE-o-o?B--o?o?MXB-B-E-?-oBEEEo-----?Eoo--oBEEB-?EoBE?----E?B-ETB-Bo--?-?MB-M-Eo-X-oBB?-B?--?-E?-MBB?-oo-MM--B?B-?B-TBBoT---?-B-M-X
XXXXXXXXXXXXXXXXXXXXXXXXXXXXXXXXXXXXXXXXXXXXXXXXXXXXXXXXXXXXXoXXXXXXXXXXXXXXXXXXXXXXXXXXXXXXXXXXXXXXMX-XXXXXXXXXXXXXXXXXXXXXXXXXXXX-XXXXXXXXXXXoXXXXXXXXXXXXXXXXXXXXXXXXXXXXMXXXXXXXXXXXXXXXXXXXXXXXXXXX
