-------------------o----Eo-------E----o-?----------?---E------------E------?----------?----?---X----?----o--o--E----------------------------o----------B------?--?------E?-?---?-?B---------E--BE-------
-----E------------?-------??---------o---------?-?------------------?-B---?E----X------M---B---?-B----o------M---------B-------E-M------T-T----------?-------------o---X------?---------------------o---
--M----------B-----------o---o-o---T----E---------------------------ME---Xo----o---M-------B-E------EB----o----X-----------------------------------?-----E----------------------B?B--------?---------M--
---------------------T---o------------------------B--------------E--?----o-------o-------E------TE--M--B-----M--------------------E------o--------------?-------o-o--------o-o----E-------o-----?-------
---?------E----------o-----?-?-------E-------------X------?o------o-?--oE---E--o-?---------------E------?------------B-?B--------B---o------------B--?--E---?---------------o-----------------?---o---o-
-------o-------------o?--?----------E------------------E-EB-----E--M---------------?----E--E-E---------X---E-?o------oE-------B----?---------B--------B--o--??-----E--o---------M-----------o--o---B----
-----E----------B---E-------o--------?-o-----o---?-----?------------------oM-------?---------------------o-------------?E-------------o-E--------B-------------E--E-----------------------o----E--------
-----------?--?-------?-o---------?---------B----E----T---------o-X-?----------M-------?-E---------T?------------------------B-M--Xo---M-----Eo---------B-E------------?-M------------E----------B--?--v
----B-----------?----o---B-----------o-----------EB----------?---------ME----------------------B--EM-------------------?-----M-X-------E----B--------o------------?-------X-------------------EB-----M-f
-M-------------o-----------------o-----E---------M-------------------------------M--o---------------E-?-------o-----M-------------B--?-----o---E------?----------M-----BX----?M--?-------------------?-f
----------E------o--------------o-oo-----------?-o------B---o----------o--oE-----------------E-----------------B----X-E----E------o----------E------B-?------------------E---?--?-----B--?----M--------f
--B---E-?---X?-?---?B-----------B----?-B-----o----------------o--------B-----?---M---?-??-B--o-----?-------------?-------??---------?-----M--------------o---------M----------BB-o-------------o--X---of
----T----------------------E----------------o-?--B-?----?-o---??-----E?B?-----?----------------E----------E--??-----E-----------o--oo--------------------------------------E----M---o--B--o-X------o---f
-----oE-------------B--?----X-E---?--E-----?-----?-------T-E-?--T--?-E---------?------?E---------M---------------M------------T-B------------o---o-----------E-o---?---E------o--o---?-B---M-----M--X--f
m?--?-------------X?-------?------?--------EE----B?--X-EB---E-------M----E-----------B---------B-M--------?--?--B--E----------?-E---?------T---?---------------B-----------------------?B-----M?----?--X
XXXXXXXXXXXXXXXXXXXXXXXXXXXXXXXXXXXXXXXXXXXXXXXXXXXXXXXXXXXXX-XXXXXXXXXXXXXXXXXXXXXXXXXXXXXXXXXXXXXXXXXXXXXXXXXXXXXXXXXXXXXXXXXXXXXXXXXXXXXXXXXXXXXXXXXXXXXXXXXXXXXXXXXXXXXXXXXXXXXXXXXXXXXXXXXXXXXXXXXX
