---o-----?-----------?---o--------o--------------?-------------------------?---E---------B----o---?-------?-E---M--o-------B-------------E---------E-------------?-B------EX--------------------?-------
-----oE--------------------o---------B---------------E---oo---?------o-----------E----------------o--------E--------?----------X--?---?---E-------E------?-------E-----------------------------------M--
---------T------?-------------------E---------M------------------------------------------?-----?M---M------E-M--X------B---------T---------?-----o-------------o--oE----M----------------------------B--
--E?-------T--o---------------------B-------X--M-B-E----B----------?--E---E----------------------?---Mo------------?---------o-------o--------?o-Bo---------?-?--EEB----M------------------oo--------B?-
--------M--------TET----------------X-EB----?--------E--X---------?-o------------------?------------------?-------------E-----M-TXB----B--E?------?-------M------BM-----------o---E--E------------------
----o----E--------oM-----o----o-?------------------------M---------o--o-------------B--?--?---E-EM--?--------?-------M-------------?-----------E?-o----------oo-M-----T-----------------------?------M--
----------M-----?--E-B--------E-------oE--------o----------E---?-----------o----?----M-----------o-----?---E---------B---------------------------E--------------??-?---------Mo-o---------o--?----------
-o-----------------------------T-----------------M-ME-------B-MX-------E---Bo---E--------E-----------E---o---------------X-------------M--E----------------------?-----B------E-B-------B---------B--o-v
-------------B--E---E---------------------------o--------E--------------oE-------------------------?----?---o--------------B-B-?--o--------------?--B--E----?----M-BM--E--E-----X?B---T------------E-?-f
----T--E--------?-o--o-----------E-------E-?------------------------B?---o-oo---?--------E---------E-----------E-----------E-----XoM-------------------M----o-E-------E----o-----E----?T---B-----------f
----------E--?-----------B---?--M----??-M-----------?-----M--------X-----------------o------------------------?-----------------?--------?-o------E-E-X-------------E--B-E-----o-----M----E------------f
-o-----B-------------------------------MM-B-----------------?------BB------o----E-----?-----------B-M-?---E-o-BX--E----------------o?---M---B--------?----------B--------------?--?----------B-?-o----?f
--?o---?----B----BM-----B------------o-o----?------E----oM----?-----------------------------------------------o-------------------------------------------E-o----------T---o---E---EB--------------M-?-f
-------------------E---E----?--------------B----o--o---T---E-----------------?o--------------ET--------------------?-----------------o-E--------------o------o-E?----?-------E-o---E-------------------f
m---B----X-----?--o--?-?-X--------X---?--------E--?----o-----T-----B---------------------------M----------B----?----?o?---o----oB---------B------------?-?---?---?-E---EB----T--------------E---?-?----X
XXXXXXXXXXXXXXXXXXXXXXXXXXXXXXXXXXXXXXXXXXXXXXXXXXXXXXXXXXXXXXXXXXXXXXXXXXXXXXXXXXXXXXXXXXXXXXXXXXXXXXXXXXXXXXXXXXXXXXXXXXXXXXXXXXXXXXXXXXXXXXXXXXXXXXXXXXXXXXXXXXXXXXXXXXXXXXXXXXXXXXXXXXXXXXXXXXXXXXXX
