------M---oo-----?-------------B?-----B-----M--------X----------------------o------X-------o-E----B?-------?-----M--?-----------?---?---E--M?--B-----?-T---------------o----X-----o---o---E-----M----o--
--E-----?------ME------o------E-------B---M----?----------------------E-o----o-E-E--------------------E---B----o----T-------?--------B----o--E------E?-E-E------E---------------o--X-?--E---------?-----
-o---------------------o--BE--?--B-?------------------------T-???-BEE-E--------------BE-----o-X------------------BE-E--?M-M------?--E---?------X------------?--------------------E-B----------------o-E-
----B?-------M------?-----oB----------------EX---E--o-------------------------o----??---o-E-------B-oX----?E---o-----BM----?------o-o-----B---------E--------Bo-?M?----------?---?---?---?--o-----?--E--
---X----o------------B----??------T--B-------?---o-------?EX-----------M--E-o---------o----E----o--M-E---B---------o----------oE-E--------------E-?---?------B-------?--------o---------------o-o-B-??--
-M-B------T--?E-E-MBo---------------B-------o---E--?--EMo------B-----?-B?----M----------o-?-----?-----?--------Eo--?------o?----------EME--o?-M----o--B-B----X----o--E-----M-B--B-----oE--B--TE-MBo-----
------------------------?-----E---E---EM------?-o---E---?---------?-Eo-----------E---o------------------B-??---E---------M-----M-----T------o----------o---------?--o-------EM--B-o----------E-----B--o-
-------o?---------?---B---------?------M----B-?-?--o-----?B----o------------B---------TB---oE---------------EB---o--------------E--o-------------E-------E-o---------T-----?--B---B?-------?M--B--Bo--Bv
---o------??---oo-------E----------X----------B--------E-M---M-----?B---?-M--?-----o??--------o---X-?-----------------E--?----?-o--?----M--?---------EE----M---E--?---------o---?---oB---?E----------E-f
----B?-E----B-E--B--B-o-o---------------------B--------E-E---o--?---B--Mo-------?----o------------o----------E------o-----T--o-------MMM--o-------------------------E----M---oB-------o---------?---E-of
-X----------M-----------E--?B?--o---o----B-----X-----?----?----E-----E--M-----------------?M---?-----M-------------?-B----X--?-----------o-o---------E--------?-----------oE---E---B----------B?-------f
-------B------?-----------?Bo------------E------o-E-----------BX-o--B--E----------------M------EB-?---E----------B------E-------------Bo---------o-B--ME---?-------------B?-?E--M--B----------o--------f
-o-B-oMo----M---?-----------------------o---M---------------?---B---E----o--o----EX--------o-o---------?-EM--B-M----------?------M-E-------------o-?---M------B------M--?-----E-----------B---E----E---f
----o--B------E-----B--E?------E-------o-M----E--E-?----EE---------B------------o-BE-----------M--------------------?-----B------?-M-E---------?------------------------M-------E-------?E--o-B--oE----f
m---?-----?-X-?--B------?-B--T-----EE--BE----?-----B--oB--?---E-?-o--------B?---B-----B--E--?-E--B---?---B--------E?------?---??--?-E?-oX--E---?-----E-B-Bo-?--?--?---?-----B----B-?-?-?--?---?-Eo-B-T-X
XXXXXXXXXXXXXXXXXXMXXXXXXXXXXXXXXXXXXMXXXXXXXXXXXXXXXXXXXXXXXXXXMXXXXXXEXXXXXXXXXXXXXXXXXXXXXXXXXXXXXXXXXXXXXXXXXXXXXXXXXXXXXXXXXXXXXXXXXXXXXXXXXXXXXXXXXXXXXXXXXXXXXXXXXXXXXoXXoXXXXEXXXXXXXXXXXXoXXXXX
