-------------------o--o-Eo-T-----E------?----B-----X---E------------E-------------------------B-----?-----B-------?----?-------------------------------B--------------------------E----------T----------
-----EE-----------?-------??---------o-----------?-----B------------------?E----X----------B---?-B--------T--M----o----?-B-?-----M--------T----------?----?E------------M-------M------o---E----B-------
--M-----M-------------E--o?--o--o---M-----------------M---------B---ME---Xo--E-o---M--B----B-E------E?---------X---------B------------?E-o---------?-B----------E-----B-------------------B--o----------
---------------X-----T---o--?-------?--o--------o?B--------B-o-o---------o-------o--------------TE--M-----------------------------E------o--------------?------o-------------?-?------M-?-M-------?-----
---?-----------------o-------?--B----EE------?-----X------?-------o-?----------o--B---------------------?-?--------E-------?--E--B---o------------B-o?---ET--E-----------?-E-------E---B--o--------X----
-----E-o---E---------o?--?----------E--------------B---E-oB-----E--M-------E-------?----E--E-E-------------E-?o---------------B----?------o--B------Eo---E--E----E?-o------------B---M-E-----------M----
-----E----------B--oEE------o----------o-----o---------?-------------------M-------?-------------E-o-BT--------------o-------------B--o-E--------o------EM----T-?-----o-E-----o------o----------------?-
----E------?----------?-------?---?-----E---B----EB---T--X------o-X-?----E---T-M---------E---------T?-------------o-E------o-B-M?-Xo---M------o----------?----o----?--------------?----?-----?E-----E--v
----B-----------?----o---B------------------------B---?------?---?-----ME---?------------------B--E-----------------------B--M-X----?--E----B------E-o---------------E----------------E--?-------------f
-M-------------o-------T---------o-----E-----?---M------------------o------------M-----B------------E-?---?---o----------------------?-----o----------?--EB------o-----E------------Xo--o------?-------f
----------E-E-M-----------?-----o-oo------E------o------BE-------------o--o-----B---------------------B---------------E-----------o--M----o----o------?------B-E-------------------------?-M-------E---f
--B---E------?-----?B----X------B?---?-------o----------------o--------BT-E--?---M-----?-?B--o---E-?------------X----o---E-M----?---?-----M---?-----?------E------EB?--------?-------?--o---------?--B-f
----T----------Eo----------E----------------E-?--B---X----o----?------?B------?----------X----?-----------E---?---o-------------o---o---------------------?-----??-----?----M---------?---o-------E--o-f
-----o--------------B--?----X-E---?--E-----?-------------T-E----T-o?-E--??-B---?------?--------E------------------X----E------T-B------------o---o----------------?-----o??----------------------------f
m?-B?--------------?-E--E-Xo?-----?-?------EE----B?----E---?E-------M----E-----------B---------B----------?--??-B-------B-----?-E---?-B----T-------?------------------------B-----?-X----------?-E-?---X
XXXXXXXXXXXXXXXXXXXXXXXXXXXXXXXXXXXXXXXXXXXXXXXXXXXXXXXXXXXXXXXXXXXXXXXXXXXXXXXXXXXXXXXXXXXXXXXXXXXXXXXXXXXXXXXXXXXXXXXXXXXXXXXXXXXXXXXXXXXXXXXXXXXXXXXXXXXXXXXXXXXXXXXXXXXXXXXXXXXXXXXXXXXXXXXXXXXXXXXX
