------M---oo---T-?-------------B?-----B-------------MX----------------------o------X---------E----B--------?-----M--?-----------?---?---E--M?--B-----?-T---------------o----X-----o---o---E-----M----o--
--E-----?------ME------o------E-------B---M---------------------------E-o----o?E-E--------------------E---B---------T-------?--------B----o--E------E?-E-E------E---------------o--X-?--E---------?-----
-o---------------------o--BE--?--B-?------------------------T-???-BEE-E--------------BE-----o-X---------------X---E-E--?M-M------?--E---?------X------------?--------------------E-B----------------o-E-
----B?-------M----BE?-----oB------------?---EX---E--o-------------------------o----??---o-E-------B-oX----?----o-----BM----?------o-------B------E-----------Bo-?M?----------?---?---?---?--o-----?--E--
---X----o------------B----??------T--B-------?---o--------EX-----------M--E-o-o-------o----E----o--M-E---B---------o--B-------oE-E-------------oE-?---?----o-B-------?--------o---------------o-o-B-??--
-MEB---------?E-E-MBo---------------B-------o---E--?--EM-------B-----?-B?----M----------o-?-----?-----?---------X--?------o?----------EME--o?------o--B-B-E--X----o--E-----M-B--B-----oE--B--TE-MBo-----
------------------------?-----E---E----M------?-o---E---?---------?--o-----------E---o-----------B--E---B-??--?E---------M-----M-----T------o----------o---------?--o-------EM--B-o----------E-----B--o-
-------o?---------?---B----------------M----B-?-?--o-----?B----o-----------TB---------TB---oE--------------ME----o--------------E--o--------E----E-------E-o---------T-----?--B---B?-------?M-----Bo--Bv
-?-o------??---oo------------------X----------B--------E-M---M-----?B---?-M--?-----o??---?----o-----?---------?-------EM-?----?-o--?----M--?---------EE----M---E--?---------o---?---oB---?E----------E-f
----B?-E----B-E--B--B-o-o-------------X-------B--o-----E-E---o--?---B--Mo-------?----o-M----------o----------E------o-----T--o-------MMM--o-------------------------E----M---oB-------o---------?---E-of
-X----------M-----------E--?B?--o---o----B-----X-----?----?----E-----E--M------M----------?M---------M-------------?-B----X--?-B------B--o-----------E--------?-----------oE---E--------------B?-------f
-------B------?-----------?Bo------------E----B-o-E-----------BX-o--B--E--------o-------M------EB-?---E----------B------E-------------BoM--------o-B--ME---?--------------?-?E--M--B----------o--------f
-o-B-oMo--------------------------------o---M---------------?---B---E----o--o-----X----B---o-o-----------EM--B-M----------?------M-E-------------oE?---M------B------M--?-----E-----------B---E----E---f
----o--B------E-----B--E?------E-------o-M----E--E-?----EE---------B------------o-BE---------------------------E-o--?-----B---o--?---E---------?------------------------M-------E-------?E--o-B--oE----f
m---?-----?-X-?---------?-B--T-----EE--BE----?-E---B--oB--?---E-?-o--------B?---B--M--B--E--?----B---?---B--------E-------?---??--?-E?-oX--E---?-----E-B-Bo----?--?---?-----B----B-?-?-?--?---?-Eo-B-T-X
XXXXXXXXXXXXXXXXXXMXXXXXXXXXXXXXXXXXXMXXXXXXXXXXXXXXXXXXXXXXXXXXMXXXXXXEXXXXXXXXXXXXXXXXXXXXXXXXXXXXoXXXXXXXXXXXXXXXXXXXXXXXXXXXXXXXXXXXXXXXXXXXXXXXXXXXXXXXXXXXXXXXXXXXXXXXXoXXoXXXXEXXXXXXX-XXXXoXXXXX
