---------M-o----------?--?-----B-E-------------?-----X--B----M----?--------?---E?--------?-------MM-------?----------------B----------B----B?-?------E------?o-----B------EX--------------------?-M-----
-------?E------?-----oBB--------------BE-------B--EB----B---M--------o-----------E-----------?----o--------E---------------?---E------?-X---------E---------------M-------------------------------?-----
-----------?-M------------E----------E--------M--------o---------------------------------?-B----M-----o----E-M--X--?---B---------T--B----------M-o-------------o---E----M-B------o------------M------B--
------E--------E--E-----M-?-----------------E--M-----------?----?-----E---E----------------------?---------------------------?-?--------B--------B------------?--E------M-----o-------E----oo---------?-
---Eo-?----------B-?-------------T----EB----------------E-----------o-----------------X-------------X-------------------E--T----TXE----B-------?---------------E------------------E--E------------------
-------M----E------------------?----------------------?-o-o------o----o-------------B-----?---E-EM--o--------?-------M-------------------Eo---------------------------T-----------------------?----M-MM-
-?--?--?-----------E?-----------------o------M-----?----M--E---------------o----?----M-----------o-----?---E---------B------------E--------------E-----T----X----BEE---------M------------o---------?---
------?----BM------?X---------------o---------B--M--T--E--T----X-B-----E---Bo----------B-E-----------E-E-o-----------------------M----------------E-------E---------------o--oE-E--------------------o-v
-------------------?-----?-------------------?------E-------------------oE-------------------------?----?---o--------------E---?----X-----B------?-?B??E-----o-----BM-BE--E?----X?B---T-?---------ME-?-f
-----E----------o-----B---o--------------E-?--E--------M----E-------B?----------?--------E---------E-----------------------------X----------------B-?E----?----------------o-----M----?T---------------f
--T-X-------?---------o--o-----E--------M--------------------------X----o------------o-T-------X--------------?-----------?-----------------------E-------------------?--E-E---o-----M----E------------f
------o------------------EB---EX-----?----B-------------oME--------oB------o----------?-E---------B-M-----T-o-B-?-o-----B--------------?M---------E------B?-?---B----------E------?-----------B?-o-----f
-o-----?----------B------?---M-----o--X--?------B--E--o-E------?--E-------------?-----------------------------------B---------------------------------?--E-----B-----------o---E---EB-------------?M-?-f
-------EE----------E--------M-----------B-------o---M-------------M--M----E---o---------B----EE--o---------------o--X---------?------o-EEX--Mo---------o-----o-------?-T-----E-----EMo-----------------f
m-?-----B-M--------B-----?----E----o-------?---E--?--B-?-E-?-T-B----E?---------?---------------M------o?-------?-----?E---------B-----B?E--?------------E?---------E---EB----T------?-------E---?-?----X
XXXXXXXXXXXXXXXXXXXXXXXXXXXXXXXXXXXXXXXXXXXXXXXXXXXXXXXXXXXXXXXXXXXXXXXXXXXXXXXXXXXXXXXXXXXXXXXXXXXXXXXXXXXXXXXXXXXXXXXXXXXXXXXXXXXXXXXXXXXXXXXXXXXXXXXXXXXXXXXXXXXXXXXXXXXXXXXXXXXXXXXXXXXXXXXXXXXXXXXX
