------M---oo-----?-------------B?-----B-----M--------X---------?E-----B-----o----B----X------E----B--------?---?-M--?-----------?---?---M------B-?----o--o-------------o----X-----o---o---E-----M----o--
--E---?-?----E-ME----------?--E-------B---M-----------------------------o----o-E-E--------M-M---------E--------o----T-------?--------B----?--E------E?-E-E---X--E----E----------o--X-?--E------o--?-----
-o----------------E-------BE--?--B-?--------------------------???-BEE-E--------------BE-----o-X-------------------E-E--?M-M------?--E----------XB------------T-------------------E-B----------------o-E-
----B?-------M------?-----oB-E--------------EX---E--o--------------M----------o-E--??---o-----------oX----?----o-----BM-----------o--E------------------?-E--oo-?M?----------?---?---?---?--------?--E--
---X----o-----------------?--E----T--B-------?---o--------EX--?--------M--E-o---------o---------o----E-------------o----------oE----------------E-?-----------M------?--------o----?----------o-oXB-??--
-M-B---------?E-E-MBo---------------B-------o---E--?--EM--M----B---E-?-??----M----------o-?-----?-----?--BE----Eo--?------o?---------EE----o?-----------B---------o--E-----M----BE----oE--B--TE-MBo-----
------------------------?-----E---E---EM------?-o---E---?---------?--oE---------------oX----------------B-??---E---------M-----M-----T-----------------o------------o-------EM--B-o----------E-----B--o-
-------o?---------?---B--------------o-M----B-?-?--o-----?B----o------------B---------TB---o--E------------E-----o--------------E--o-------------E-?----ME-o-B-o-----------?--B---B?-------?M-----Bo--Bv
--?o------??---oo----------------T-X----------B--------E-M---M----B?BB----M--?------?---------o-----?-------------?---E--?----?-o--?----MB-?---------EEBo--M------?---------o---?---oB---?EM---------E-f
-----?-E----B----B--B-o-o----EE---------------B--------E-E---o--?-o-----o-------?---?o------------o----------E------o-----T--o-------MM--B-----B-------E------------E----M---oB-------o---------?---E-of
-X----------M---?----?--E--?B---o---o----B-----X-----?----?----E-----E--MB----------------?M---------MM--?---------?-E----X--?-----------o------M--E----------------------oE---E--------------B?-------f
-------B------?-E---------?Bo------------E------o-E---B-------BX-?--B--E------------------?-----B-?---E----------BE-E---E-------------B----------o-B--M----?E-------------?-?---M--B----------o--------f
-o-B-oMo--------B-----------------------o---M-------?-------?---B---E----o--o-X------------o-------------EM--B-M----------?------M-E---------------?---M------o------M--?-----E-----------B---E----E---f
----o--B------E-----B--E?------E-------o-M----E--E-?----E----------B--------------BE---B-------------------E--------?-----B------?---E-X---?---?---o-----------------E--M-------E-------?E--o-B--oE----f
m---?-----?-X-?--B------?-B--T-----XE--BE----?-----B--?B?-?---E-?-o-B-----?B----B-----B-EE--?----B---?-T-B--------E-------?---??--?-E?-oX------------E-B-B-X---?--?---?-----B----B-?-?-?--?---?-Eo-B-T-X
XXXXXXXXXXXXXXXXXXMXXXXXXXXXXXXXXXXXXMXXXXXXXXXXXXXXXXXXXXXXXXXXXoXXXXXEXXXXXXXXXXXXXXXXXXXXXXXXXXXXXXXXXXXXXXXXXXXXXXXXXXXXXXXXXXXXXXXXXMXXXXXXXXXXXXXXXXXXXXXXXXXXXXXXXXXXXoXXoXXXXEXXXXXXXXXXXXoXXXXX
