---?---------------ME--o-?-o--------------M----o-----X--B-----B--E---------?---o---------o---------------------B---BX----?E----T-BEBo------------M---?-----------?-B---------o-E---------?------?-------
---B--------B--?E---o--B----M--------?--------------o-----------ME-B-o-B-----T---E------------oE--o-----X--o---------o--?---M-----T-----T------------?--E---B---------o----------??----------T---o---o?-
--------E--E---?----oX----B----------------------------o--------B---E--------------------?---------------o------------B--E-------------------------------M-----o-----?---E-E--o---o---------------------
------E--------E----------?M------------------?----?----------------?-E---E--?--M?---------------?-o--------?-----B-----------E----M--------------EE----------?o-E-------------------------o--E-?-----?-
-M-E-------------B-?-E-----B----?--o------X----X-M---Eo-------------o---------E-----X--M------------o---?--M-------------E----------E-BM-oo-o-M----T---------------?-----?o----------E?------?----------
-------M-ET-E--EB-----------BE--------------o-----------?-------------X-------------B---------------------B??------?----------o--E--E---------------------------B--?E-B--------------?-----E--?o---o----
-?--?-?B--------------------o-----B---E------------B-o--M--E--?--E--E----E-o----E------------------o---?-----------M----B-------B----------MEE--?--E?------------------------------------B---E----------
--?---?---MBB---------------------------------?---o--B------B--X-----------B------------EE--?----E---E------------?----?E---o?B---------------------------------M-----T----MoE---------B-------------o-v
----------?---------?--------B-X-?---------?---M----------------------?-o---B--------E------E------?--E--------------o-E-------------------?------E-B--EE------E---B--B----Eo---o?B-------o----M-------f
-----E-------?--o-----BM--o--M---?--------------o-------------------B------o----?-------oE--T-?--------o---------o-E-T-------------------------M-M--------------------------E---------?-----?------E--?f
----o-o?----oE---?--------------------?------T------B--------------X-------B?---?-?--oB--------?-----M-----E--M--?---E-----------------?------??-BEM-----X---oB----E-----E--?--M-----M---o------o----o-f
---------X--------------------B-------M-B---E------------?-----------------?-----o----------------B-M-------o---E---------------------------M-------?--------B--B------?o-T-------?-----?------?-?--o--f
-o---------X---BEB-------?--E--B---------M---------EM-----------------------------------------?o---XE-----------------E------o----------------------?----E--B---?----Bo-?------E----M--------------M-?-f
-------------E---E-----E----ME-?------M---------?oo---------E-B-------B?--B---?--------------E-----------o-----------B-B------T----B----o------E-----E-------o------E----E-----------------------------f
m-?-----B---------X--------M--------?---o----E?---?--B-?-----T------?--------?E------?-----------B-?------------M----o-B--?-?----?---------------?-------?--------BE------?--?----------B---EE--?-?----X
XXXXXXXXXXXXXXXXXXXXXXXXXXXXXXXXXXXXXXXXXXXXXXXXXXXXXXXXXXXXXXXXXXXXXXXXXXXXXXXXXXXXXXXXXXXXXXXXXXXXXXXXXXXXXXXXXXXXXXXXXXXXXXXXXXXXXXXXXXXXXXXXXXXXXXXXXXXXXXXXXXXXXXXXXXXXXXXXXXXXXXXXXXXXXXXXXXXXXXXX
