--B----------E-----o---?-------E-B----E--------E------------EB----E-T----o--X----?----?-------------?----------?--?------------------------------------B?---o-------?-----------------E-----E-----------
-----E----o-------?----------------B----o--T--------------------------------?B-------------B---?-B-----------M----o------B-?--XE-M-?------T-----E----?----?E------------M-------M------o?---?-------o---
--M-------------------Eo----E-------------------------B----------------T---o-------B-------B-E------Eo---------X---------B---------------------?---?--------------E---B--------------------?B--------M--
--o------o--o-------------E--------?-------XooE--B-----?----?--------?-E-----------------------?TE--MB----------?oo---------M-----E------o--------------?------o-------------?E?------M---o-----?-------
--o?--------------------B--E----E-------------o--B---------?------------X----?-E-B-E-------------------X?------------------------B---o-------E----B--?---ET--E-----------?-------------B------?---o---B-
-------o-o---------o-----------B------------------?-o--?------------?-------?E---o--B---E--E-E--o--------M-E-?o---------------B----?---------B-----------E--E-------o-----E---o------M-E-------?--------
-----E----------B---E-----E?------o--o-------E-E---oM---?---E--?---B---------E----------------?B---------------------o----------------o-E-E--------------M----T-------o-E-----o---E-------o-------------
-----------?-------------------?--------------------B------------o-E--------------?------E---------T?-------------o-E--------B-M--Xo---M------o----------?----o---------------B---?----?---------B--?--v
----B-----------?---------B-?-?--------o--?----------------M--B-------o----?--------------M----B--E-----------------------B-EM-X-o--o?-E----B--------o--------E------------B-----------------MEB---o?M-f
-M----?--------o----E-----?--X--------B-Eo--E-E-------B------E----B------E----E---MM----------------E-?--?----o-------o-E-----o------?-B---o-----o----?--EB------o-----EE-----------X------------------f
----------E--------------------E-o---------B-------?----------------E--------?-------------?-------------B------------E-----------o-------------------?------B?---------------X--X--?----?----M--------f
--B---E------?B----?B----?-o---o------------------------------EE-o----------------o-E--?--B--o-----?----------?------o-----M--------?--E--M----------------E------E-?----------------?--M------o?-X----f
----T-----------E--E--?----------------------o----------------------?B-?-------E--------------------------E---?---o-------------o---o---------------------------??-----?--------------?---o-T--------o-f
-----o---------E----B---?E--Mo-B------T--o-----?-----------------------------B--------?-------?------------M------X----E------T-B------------o---o--M-------------?----E-?--------E--------M-----M--X--f
m?--?-B-------o----?-M-----?---TM-B-------------------?--------B-o--?X-----------X-B-B---------B------M---?--?--Bo------B-----?-E---?------T--E----M------------------E-----B-----?-X---------M?----?--X
XXXXXXXXXXXXXXXXXXXXXXXXXXXXXXXXXXXXXXXXXXXXXXXXXXXXXXXXXXXXXXXXXXXXXXXXXXXXXXXXXXXXXXXXXXXXXXXXXXXXXXXXXXXXXXXXXXXXXXXXXXXXXXXXXXXXXXXXXXXXXXXXXXXXXXXXXXXXXXXXXXXXXXXXXXXXXXXXXXXXXXXXXXXXXXXXXXXXXXXX
