--------?-----------------------------E---M----o-----X--B--------E-------?-?---o----------M--------------------B---------------T--EBo------------M-?----------?--?-B-------X--E----------o------?-------
------B-E--------E--------------o--oo--------------------E---------B-o-----------E--E------------Bo-----E----E----------?---M-----T-----T------------o-?-EM-----------------EE---?---------E-----o---o?-
------?-E---o-----E----------B--------B---------M------o--------B---o------------------M-?-----?---X-----o------------B-B------------------E------o----EEB-o---?--------M------------oB-----------------
------o-E-------------------------------------------------------------E---E-------------------E--?-o---o----?M----B---E----------------------------------?--o-?--E------M------------------o-?----------
-----M---E--To-M---M---E-B--------X-------X----o-M----o-------------o--------oE-------?------------oo-----?M-------------E----------B-BM--o--E-E-------o-----B?--o-------------------E?------?--------E-
-------E-----B-----B-------------------------E--E--o----?-------------X-------------B---------------------B??--------------------E--E-----?-----?---------oB--E-B--?-----------------B--------?---Mo----
--E----M----B----BE-------------------o-------------oo--M--E---B-E--?---M--B----E------------------o---?-----------M----B-------B-----------EE----------------o--------------M--------------------------
---?-?--------?--T---------?-----o------------?---o------------X-o---------BM------------EB-?----E---E-----------------?E----------M-------o----E----?-?-E------M-------------E----------------------o-v
----o---------E------E--B------o--?-------??---M--------X-------------E-?------------E-------------?--E--------------o-Eo-------------E-----M-------o----o-------X-BM--E--E-----o?B-------o------------f
---E?--------M--X---------------?-------o-------o-----B--E----------B-----------?-------oE--T----B-----o--------Mo-E-T---E--------------------o--------------?-?----------oo-------E--?------B--E--E--?f
-------?-----?--------E-------M-------M------T------B--------------X--------------?--o---------------M-----E--M--?-B-E-------------------------?-----B-o----?------?-----B?o?--o-----M---o------o------f
---------o--------?--------?--B--X----o-----E-----?---------------E?-------?----------------------M-M--T----o---E----?-------------o------o-M---o---M------E--T-B-----X-----------?-----?------?-o-----f
---o----E-----------B------------o-B-----M---------EM-----------?------------------------------o-----B----------------E------o--------------?---M-------B--E---??----EE------E-E-----------E-------M-?-f
-------------B--?-------------------------------?-o--T--------B---o---B?--B---?--------------E-----------o-------------B---------o-B-M--o-------------------?-?----------------------------------------f
m----X-----------X---------oo--?-X-----------E?---?--B-?-----T------?o-BE------------?-------------?------------M--B---B--?-------BE---------E---B----M--?M--------E---EX-B--T--------------E---?-?----X
XXXXXXXXXXXXXXXXXXXXXXXXXXXXXXXXXXXXXXXXXXXXXXXXXXXXXXXXXXXXXXXXXXXXXXXXXXXXXXXXXXXXXXXXXXXXXXXXXXXXXXXXXXXXXXXXXXXXXXXXXXXXXXXXXXXXXXXXXXXXXXXXXXXXXXXXXXXXXXXXXXXXXXXXXXXXXXXXXXXXXXXXXXXXXXXXXXXXXXXX
