------M---oo-----?-------------B?--------------------X---------?E-----B-----o----B----X------E----B--------?---?-M--?--o---?----?---?---M------B------o---M------------o----X-----o---o---E-----M----o--
--E-----?----E-ME----------?--E-----?-B-B-M----------------------E------o---Bo-E-E--------M-M---------E--------o----T-------?--------B----?--E------E?-E-E------E-----------E---o--X-?--E------o--?-B---
-o----------------E-------BE--?--B-?--------------------------???-BEE-E--------------BE-----o-X-------------------E-E--?M-M------?--E----------XB------------T----------E--------E-B---B---M--------o-E-
----B?-------M------?-?---oB-E--------------EX---E-----------------M-------?--o----??---o-----------oX----?----o-----BM-----------o--E------------------?-E--oo-?M?----------?---?---?---?--------?--E--
---X----o-----------------?--E----T--B-------?---o--------EX--?--------M--E-o---------o---------o----E-------------o----------oE----------------E-?-----------M------?--------o---------------o-ooB-??--
-M-B---------?E-E-MBo-----------M---B-------o---E-M?--EM--M----B-----?--?----M----------o-?-----?-----?--BE----Eo--?------o?----------E----o?--------M--B---------o--E-----M----BE----oE--X--TE-MBo-----
------------?-----------?-----E---E----M------?-o---E---?---------?--o----------------oX----------------B-??---E---------M-----M-----T-----------------o------------o-------EM--B-o----------E-----B--o-
-------o?---------?---B----------------M----B-?-?--oM----?B----o------------B---------TB---o--E------------E-----o--------------E--o----------o--E-?----ME-o-B-o-----------?--B---B?-------?M-----Bo--Bv
---o------??---oo------------------X----------B--------E-M---M----B?BB----M--?------?---------o-----?-------------?---E--?----?-o--?----MB-?---------EEBo--M------?---------o---?---oB---?EM---------E-f
----B?-E----B----B--B-o-o----EE---------------B--o-----E-E---o--?-o-----o-------?---?o------------o----------E?X----o-----T--o-------MM--------B-------E------------E----M---oB-------o---------?---E-of
-X-o--------M---?----?--E--?B---o---o----B-----X----E?----?----E-----E--M-----------------?M---------M---?---------?-E----X--?-------E---o------M--E--------------o-------oE---E--------------B?o------f
-------B------?-E---------?Bo------------E----B-o-E---B-------BX-?--B-?E------------------?-----B-?---E----------B--E---E-M--------B--B----------o-B--M----?E---------------?---M--B----------o--------f
-o-B-oMo--------B---------------M-------o---M---------------?---B---E----o--o-X------------o-------------EM--B-M----------?------M-E---------------?---M------o---------?-----E-----------B---E----E---f
--B-o--B------E-----B--E?---M--E-----X-o-M----E--E-?----E----------B--------------BE---B-------------------E--------?-----B------?---E-X---?---?------------------------M-------E-------?E--o-B--oE----f
m---?-----?-X-?--B------?-B--T-----EE--BE----?-----B--oB?-?---E-?-o-B-----?B----B-----B-EE--?----B---?-T-B--------E-------?---??--?-E?-oX------------E-B-B-----?o-?---?----------B-?-?-?--?---?-Eo-B-T-X
XXXXXXXXXXXXXXXXXXMXXXXXXXXXXXXXXXXXXMXXXXXXXXXXXXXXXXXXXXXXXXXXXoXXXXXEXXXXXXXXXXXXXXXXXXXXXXXXXXXXXXXXXXXXXXXXXXXXXXXXXXXXXXXXXXXXXXXXXMXXXXXXXXXXXXXXXXXXXXXXXXXXXXXXXXXXXoXXoXXXXEXXXXXXXXXXXXoXXXXX
