-------------------o------E------B----E--------------------?EB?---E-T?---o--X----?----------B-------?-------------?---------------M-----------------M---o--B--?---------E?-----?-?------?-E-E---------M-
-----E------B---o-?---------------M------------------------------------------B-------------B---?-B---------o-M----o------B-?-----M--------T----E-------------------o---X------?----------------o----o---
--M----------------?--------E-------------------B-----B----------------T---o-------B-------B-E------E-E--------X---------B----M------------------------o-?----------------------B?---------?---------M--
-----B---------------T--E-E-o------?--------ooE-------------?--------?-E-----------------M---E--TE--M----------E---------?--------E------o----------------------o-o--?-------o-----B-----Eo-----?-------
---?-----------------o--B-------E-------------o--B---------?-------------------E-------------------B----?------------------------B-o-o-----o----------------?---------------o-?-o-------?-----?---o---B-
-------o------o------o?--------E------------------?-oE-?------------?---M----E---o------E--E-E--o----------E-?o--?------------B----?---------------M-----o--?---------o---------ME-------------o--------
-----E--------?-B---E-----E?------o--oo------E-B---o-----M--E------B--------ME--------------------o------------------o-o--------------o-E--------------M-------E-----E--------------------o---o---------
----------??-------?--?--o-----?-------------o-------------------o-E--------------?------E---------T?-------------o-E--------B-M--Xo---M-------o--?-------E--?----------oM-------E----E--------E-B-o?--v
----B-----------?----o--?---?-?----?------?-----------------E---------o----?----------X--------B--E-------M-----------o---B--M-X-------E--------------------o-----?-------X-------------------EB--?--M-f
-M------------?o----------??-X--B-------E---E-E--------------E----B-----------E---M---------------oEE-?-------o----------B-----------?B----o--?B----B--?o--------M-----B--------o?o-----------------M--f
----------E--------------------E-o-------------?---?--E-------------E-----------------E---o---------------------------E-----------o---------------------------E----------E---?------B-B--?----M---B----f
--B---E------?-----?B----?-o----------------------------------E---------------------?--?--B-To-----?----------?------o-----M--------?-----M--?--------------E-----------------BB---------o-----o--o----f
-B--T------E-------------------B---o-----?-----o?-------------------?B-?---o------B-E-----E---------------E---?---oT------------o---o-------------?----------M------------------M---o--B--o------------f
-----o--------?-----B--??E--M--B----o-T--------?-----------------------------B--------?---?o----------------------X----E-?-?--T-B----------M-----o-----------------?---o------o--o---------M-----?--X--f
m?--?--------------?-------?---TM-B-----B-------------?--------B---T?X-----------X---BB-------BB----------?--?--Bo------B-----?-E-X-?------T-o-----M------E----B-------------?-E------??------M?----??-X
XXXXXXXXXXXXXXXXXXXXXXXXXXXXXXXXXXXXXXXXXXXXXXXXXXXXXXXXXXXXXXXXXXXXXXXXXXXXXXXXXXXXXXXXXXXXXXXXXXXXXXXXXXXXXXXXXXXXXXXXXXXXXXXXXXXXXXXXXXXXXXXXXXXXXXXXXXXXXXXXXXXXXXXXXXXXXXXXXXXXXXXXXXXXXXXXXXXXXXXX
