--X--E-o-B-?-----oE?-BT--X-Eo?-M?---??B--T-------o?o---------o----------E-------o-----o-----ME-E-?--M?-o----o-M-E?-T--E-E-E-------------M---B---------M-----B-?-------?----EX-----E---B------------o--E-
---M?-----o--???-?----oE----?--o-oBE-M---?--?------o-----o------BB--?----?----?o-Eo-EE----?-------oo---M---B----??----MM-----?--T----E--?--E---?-----------------E-------B---------------B----M---------
--E----------E--o?-------------o----E-B-----?------E-?-B?E?-?--o--o?-E-o---Mo----M-------?Eo---o-?B----M---B----?---??-BXo-----------B--E---------?----E---?-B---?------M-M---B-?o-oM------?--B-?-------
--?-E----B----------B--o---?-EE----o-o--o---E-E-M---EE--o--X-E--E--E-----oM-XB-E?---B----------T?----EM|---?-o-M-----M-----o?---?o-------------o----o--E-?M--oB--?-------BX------o-----X-------E---?----
---EE----Bo-M-o------E-B---MB-M--oE-X---oo-?o-?---o-o----------?M--E--?-E---o?-M--E-E----E----?--?-?---?---EE---o-?--?---MB----E-----T---?--------------------------M-----B---o------------o-----?------
---------B--?---T-----T--B---o----E??--?---?--?-M----o--B----Eo--MEE---?--o---?-?---M----ME--M---E-----M---?--?--T--------?-?-?------B---?-B?--?M----?------?---T----------o------EB---BXM---o----------
-------?---EEBEE--o-M--Bo----E-M-----?-B-------B-----?-?o?-----o?T-?----B-------T-o---??-E-----?-E-?---M-???--------o--o---BE-o-------T-----X---oo-------??--o---------M-o----------Mo--------T---------
--MB-o-o---------------oo------------E--o-T-?----o--?E--oo--?-------E-o??-X------?B?E--------T?--BT--E-E--------X-o---B---o--E---E-E---??-----o-E------------?M---oE-?---o-E--------EoX?-o--------o-oo-v
-B---M---?----?---B---E-----------?BB-o----?M?--?BE?X-o------?------E--TT--M---M-B--ME--?-----E-X-E----T--?----?-?-E-----o-?-M-?---?-E----------B-?o---------BE-------E-B-----o--ET----o----B---------Bf
----?--?---EEo-MoX?E-?--o---o--B---oo--?---M--X--E--------?--TB-----E------M--EE----M-----E--------?---T-E-E--------?-----E-E-M---?-?------E-E--B---------------??----M---?--------BB-Mo---------E?---Tf
----B-EB-?-M-------o-o--o-MBTo----------?--------------?---M-----E-o----------o-B--BoB--E--------T--M--BEE-B----B--E-E---E--?---E--M---EE-------B-B-----?-T--M?M---------?--M---------?-------E-------Mf
--o-----------o?--M-----o-------oB----EE--?E---B---o---B?-EEMoEE---Eoo----------?o?-----BB--X---?---E--B---E-E?------X---?-------B-MBM-----?---------o-EoM--B-B----?E-----B----o-o-o--?-----------E----f
-?--X-E-B--M--B-E-E-BE-T-B--?-----?-B----?---B-?-----------ME-B-E--------?--E---M-EEoE----Boo------?B--ME---T--TM--------?-B-----E-----o--X?-B--?------?-o--M-----------Mo---X-X---?------M---------X-of
---Bo---oM-?-?-??-M----o---M--?--E-----?---------B-?o-E--o?-E-------oo--o-o----X-?---?B--o--E?--------?---B-------B-o---o---o-------?------------------M?----T?-oB-----------B-o-?---T--B---------?---Ef
m----o-------------------B----X?----o---E------Boo------M-E------o-----?------EEo--Eo---EE-M-------B-X-|E-B--B---B--E---------BB-----B-M--o---B--B--?-M-----EX----o-----?-?---------MB-----------------X
XXXXXoXXXXXXXXXXXXXXXXXXXXXXXXXXXXXXXXXXXXXXXXXXXXXXXXXXXXXXXXXXXX-XX-XXXXXXXXoXXXXXXXXXXXXXXXXXXXXXXXXX-XXXXXXXXMXTXXXXXXXXXXXXXXXXX-XXXXXXXXXXXXXXXXXXXXXXXXXXXXXoXXXXXXXXXXXXXXXXXXXXXXXXoX-XXXMXXXXX
